WHO warns of bird flu resurgence: 	not_flu
Nov 23, Cold Remedies; Getting Ready for the Cold and Flu Season: Cold remedies and preventive measures to create an... 	not_flu
RT @letsrollforums: The War on You and Your Children Happening Right Now 	not_flu
@kelliepickler Chinese years: 2007-Cow: Mad Cow Disease; 2008-Bird: Avian Flu; 2009-Pig: Swine Flu; 2010-Rooster: Any of you men worried?	flu
Getting ready to go get my Swine Flu Vaccine	not_flu
Canadian studies says people getting the seasonal flu shot are twice as likely to contract H1N1 	not_flu
this flu season is a horrible. everyone is getting sick. makes you dislike winter that much more. winter is not fun when one has a cold.	flu
Swine Flu vs. Bird Flu vs. Zombie Flu 	not_flu
RT @cherylp59: @orionbooks review : The Things That Keep Us Here - Carla Buckley :chilling tale of aftermath of bird flu pandemic http:/ ...	not_flu
@OhSoNattral swine flu!  Ppl are scared.	flu
Congressional Libs: only thing that can save us from Swine Flu is a Public Option - more disturbing fear mongering	not_flu
Duane Reade canceled their flu shot clinics! Now where am I going to get a flu shot? I'm not getting this bug!	flu
Gucci Mane - Uptown Bird Flu.http://www.mediafire.com/?jjj5ifzzjh3	not_flu
Fear of Flu: Shifting the Goalposts 	flu
Oh yay! Getting chippy food for dinner. I'm getting a pizza supper. Maybe the grease will eat my flu bug ^_^	flu
Just returned from the Doctors. They clearly were thinking I had swine flu.. I actually have bronchitis.	flu
@billmaher response 2 swine flu captures current state of Americans: still afraid, still ignorant. When will we wake up? #religulous !	flu
Kellogg Is Getting In Trouble For Phrases Such As “hikes Resistance”: With Swine Flu making.. 	flu
vaccine 4 prevention of bird flu 	flu
My mum keeps going on about me getting the flu injection! No thanks	flu
Maanga needs to call Mbise to get the name of the vacination for the chickens to protect from bird flu. Given as a drop in the chicken's eye	flu
Reported Human Cases Of Bird Flu Or H5N1 Influenza 	not_flu
Swine Flu Vaccine Egypt: health and safety--measures taken to combat bird an..  Swine Flu Vaccine	not_flu
Meanwhile, I sat home alone worried and still trying to recover from my bout with the flu. fml	flu
Getting over the shortest bout of flu ever	flu
Worried about the news that under 5's having swine flu jab next. Anyone had it yet - any side effects?	not_flu
getting ready for Magda's flu jab in Cester, apparently healthy babies are too healthy to get one....	not_flu
Another Update Re:"H1N1 'super flu' plague in Ukraine spark concern, conspiracy theories about origins": Another fa... 	not_flu
Air Kisses, Hugs, and Other Ways to Avoid Getting Swine Flu 	not_flu
Tamiflu-resistant swine flu causes new worry 	not_flu
Go to mrsimcard.com The difference between Bird Flu and Swine Flu 	not_flu
@sarahshum Ugh. I'm getting a flu shot (hopefully) in about half an hour. :( Sorry yours is being ugly!	flu
Flu pandemic fear: too many people home sick overwhelms internet: Baltimore Sun This is not merely a question o.. 	flu
Higher-Risk Groups Getting Vaccine First: While swine flu vaccines have arrived in Laramie County, short suppli.. 	not_flu
How to Avoid Getting the Flu or Cold: 	not_flu
Just finished getting on my high horse about H1N1 - all this media hype is panicing everyone - would you normally come to hospital with flu?	flu
Flu pandemic fear: too many people home sick overwhelms internet: Baltimore Sun With the swine flu in full swin.. 	not_flu
Need Help with H1N1 Vaccine Fear? Sid the Science Kid Explains How Flu Vaccines Work:  There's also an iPhone .. 	not_flu
Bird Flu News: Sinovac Biotech files shelf registration statement with U.S. Securities and Exchan.. 	not_flu
Bird Flu News: CEL-SCI commences clinical study of LEAPS-H1N1 treatment for hospitalized patients.. 	not_flu
I hope this isn't the pig flu. Two and half days in bed and still no real signs of truely getting better :(	flu
@ivebeenlinuxed I found multiple articles about this including 'Avian flu', 'Bird flu', 'Flu (influenza)', 'Flu jab', 'Pandemic flu', 'Sw...	not_flu
isn't afraid of swine flu. Swine flu is afraid of me.	not_flu
Vaccine experts gear up for pandemic of worry - Swine flu- m 	not_flu
isn't afraid if swine flu. Swine flu is afraid of me.	not_flu
na niggas aint out wit Masks on...dat swine flu got me nervous as fucc boutta stay in for da winter	flu
I wonder what kind of flu swines are afraid of?	flu
Does anyone have any intel re: swine flu jab and pregnancy? A pregnant friend is anxious as she has heard conflicting reports.	not_flu
RT @michaelianblack: Swine flu is getting a little ho-hum. May I propose man-eating tiger herpes?	not_flu
Hahahahaha wow! RT @michaelianblack: Swine flu is getting a little ho-hum. May I propose man-eating tiger herpes?	not_flu
@MaliyaD Oh! Dats a gud thing dnt worry swine flu is nothing and her baby will be okeih .. Dnt worry for ! Be happy hunny I promess;)	flu
Flu Prevention: Bird Flu Monitor: Do Not Take The H1N1 Swine Flu Vaccine Until You ... 	not_flu
Can't believe I'm just getting  home!! I have an exam at 8am and then I'm working at the clinic administering flu vaccines! Wish me luck!	not_flu
from times & transcr Who's getting flu shots?: Is southeastern New Brunswick being left beh.. 	not_flu
#H1N1 #Swine_flu on 3 Fav Sources like Gawker-Swine Flu Hysteria Reaches a New Low: Relatives Too Scared to Att.. 	not_flu
@spurofmom3nt - Who? Dennis? Certainly not, I am just thinking the photo has been stupidly exaggerated by the media - like Swine Flu.	not_flu
BIRD FLU NEWS Effort Launched To Find And Control Diseases That Move Between W.. 	not_flu
RT @MattBesser Kanye just stopped the swine flu, saying the bird flu is the better pandemic.	not_flu
RT @michaelianblack Swine flu is getting a little ho-hum. May I propose man-eating tiger herpes?	not_flu
Anxious Crowds Meet Ad Hoc Swine Flu Police 	not_flu
Got blood all over my arm today. Fail. Hope it washes out of my shirt. Also got a lollipop for getting the swine flu jab - disappointing.	not_flu
#SwineFlu Anxious Crowds Meet Ad Hoc Swine Flu Police - New York Times 	not_flu
Anxious Crowds Meet Ad Hoc Swine Flu Police - New York Times 	not_flu
New post: Anxious Crowds Meet Ad Hoc Swine Flu Police - New York Times (	not_flu
RT @michaelianblack: Swine flu is getting a little ho-hum. May I propose man-eating tiger herpes?	not_flu
#swineflu Saudis dismiss Hajj swine flu fears but other states worry - AFP: AFPSaudis dismiss Hajj swin.. 	not_flu
@f_reddie lmfaorofl...nothing cures the pig flu like crazy white guy fros. lol. PS srsly hope u r not getting swine flu &lt;3	flu
Anxious Crowds Meet Ad Hoc Swine Flu Police: Efforts to get vaccines to those at high risk are colliding with w.. 	not_flu
RT @michaelianblack Swine flu is getting a little ho-hum. May I propose man-eating tiger herpes?	not_flu
RT @michaelianblack: Swine flu is getting a little ho-hum. May I propose man-eating tiger herpes?	not_flu
RT @michaelianblack: Swine flu is getting a little ho-hum. May I propose man-eating tiger herpes?	not_flu
RT @michaelianblack: Swine flu is getting a little ho-hum. May I propose man-eating tiger herpes?	not_flu
LOL! RT @michaelianblack: Swine flu is getting a little ho-hum. May I propose man-eating tiger herpes?	not_flu
RT @michaelianblack: Swine flu is getting a little ho-hum. May I propose man-eating tiger herpes?	not_flu
There is no need to get a flu shot its not that im afraid of the side afects it just dosent mater if your 9-60 years old	not_flu
muh. if I am getting sick and it's not swine flu I am going to be SO PISSED.	flu
NYT: Anxious Crowds Meet Ad Hoc Swine Flu Police: Efforts to get vaccines to those at high risk are collidi.. 	not_flu
is unsure about all this talk of vaccinations... def NOT getting the flu one	flu
So glad to hear Jillian will not be be getting swine flu vaccine.  I too am pregnant and don't want that crap in my body!!	flu
Mad cow (no beef), Bird flu ( no chicken) and now Swine Flu (no pork).. so guess the only thing safe to eat is pussy.	not_flu
#fb Anxious Crowds Meet Ad Hoc Swine Flu Police - New York Times 	not_flu
New post: Anxious Crowds Meet Ad Hoc Swine Flu Police - New York Times (	not_flu
Giving n & getting the flu shot....@billwhitt convinced me that vacation is more fun if I'm not sick	flu
RT @USATODAYhealth: 1.5M per day getting swine flu vaccine in China 	not_flu
Dont fear swine flu vaccine:  	not_flu
@SarahMaginnis yes. Both my girls have already had it and it was very mild - just a high temp for 1-2 days. Would be worried if flu....	flu
Top News: Anxious Crowds Meet Ad Hoc Swine Flu Police 	not_flu
@damontucker is getting the flu shot important? I never really thought about getting it, but lots of people tell me that I should.	not_flu
RT @nytimes: Anxious Crowds Meet Ad Hoc Swine Flu Police 	not_flu
@perlmunger All the cool kids are getting swine flu, but according to the resident Dr. Mom I only have regular flu. Missing all you NScoders	flu
Picked up tickets for a haunted house on Saturday. Not sure what I'm more scared of scary demons, or scary demons with possible swine flu.	not_flu
these stupid flu commercials are getting really old really fast lol... Pc4pC 8)	not_flu
Thinking about whether or not I should get the H1N1 flu shot. I don't particularly want to.	flu
is lil worried. 07 Chinese year of the Chicken bird flu; 08 Horse Australia got equine flu; 09 Pig swine flu. 10? It's the year of the Cock!	not_flu
Heard on Alex Jones radio show today...Obama's children are NOT getting the swine flu shot. Why should you?	flu
Swine Flu Hysteria Reaches a New Low: Relatives Too Scared to Attend An H1N1 Funeral [H1N1] : The CDC's complex.. 	not_flu
Ditto!  RT @KitchenStew: @5minutesformom I'm more scared of the #H1N1 vaccine than the flu itself!	flu
The best way to treat the flu?  Avoid getting it in the first place!! Check out www.uhichicago.com for some tips and advice	not_flu
Worried about Swine Flu? Check out our guide at 	not_flu
back from getting the swine flu shot. didnt hurt at all.. really..	not_flu
Mail Online: Players warned that spitting is a swine flu risk, but Bolton boss Megson isn't worried.. 	not_flu
Mail Online: Players warned that spitting is a swine flu risk, but Bolton boss Megson isn't worried.. 	not_flu
Daily Mail &gt;&gt; Players warned that spitting is a swine flu risk, but Bolton boss Megson isn't worried 	not_flu
The approach of winter and flu has you worried? Worry no more Click Me for Health Now 	not_flu
at the doctors for my swine flu shot.....many little kids are crying...im very scared help me mommy	not_flu
@hntchen I skip the flu shot because I'm not 	not_flu
Footballer spit sparks swine flu fear 	not_flu
@GraceyJones I've been hugging her most of the day!  Motrin's just reducing fever, not getting rid of it.  And her ped was happy it's flu?	flu
Do you think people are getting a little crazy about the H1N1 flu???	not_flu
Footballers Warned Against Spitting As Swine Flu Fear Thickens: Spitting stars have been issued with a stern warning. 	not_flu
RT @KeeshRedd: @WP_SHAWN hey! whats goin on wit the pic?? lol » Bird flu I move chickens!	not_flu
Do you know the difference between the bird flu and the swine flu? The bird flu requires tweetment and the swine flu reguires oinkment......	not_flu
does anyone else fear that the swine flu vaccination shot is a conspiracy?	not_flu
bird flu, swine flu, now there's dog flu...should your pet get a flu shot? More at 6 o'clock on ABC 	not_flu
Flu shots are getting mighty hard to find. Our latest: 	not_flu
Flu vaccine slow getting to Maine - Bangor Daily News 	not_flu
Parents should not fear intranasal flu vaccine. 	flu
I am thinking of signing up for flu shot, then scalping my spot on StubHub RT @ocktalks1  Flu shot's available at work this week	not_flu
RT @schmind: @Tatiana_Noel i'm adventist. its bird flu lol&lt;--LMAO!	not_flu
RT @momlogic: Cheerleader Can't Walk after Getting Flu Shot 	not_flu
I'M WORRIED ABOUT KILEY. - she’s got serious swine flu. same with my cousin. I really hope i don’t get it... 	flu
CR police getting H1N1 flu shots today.	not_flu
@ShannonKButcher oh, thank god! i thought i was getting swine flu!	flu
Swine flu vaccine slow in arriving: only 8 million doses in a week: The agency had hoped to be getting 20 milli.. 	not_flu
thats decided, going as swine flu for halloween. getting excited.	flu
National Council of Nonprofits has a H1N1 Flu Preparedness for Nonprofits page. If you are worried about how the... 	not_flu
I'm getting a flu shot for the ones I love - especially this season. You should get one, too. Pass it on. 	not_flu
1.5M Per Day Getting Swine Flu Vaccine In China - Health News ... 	not_flu
@natasharadmehr  Getting in early to wish you happy birthday for tomorrow and hope the burd flu is getting better! x	flu
Getting the flu shot...	not_flu
Getting more ringtones :) found out that the swine flu vacc, could give me cancer!	not_flu
Getting the H1N1 flu shot today. Never thought I would be excited about getting a shot lol	not_flu
#news Swine flu risk to pregnant women: A leading obstetrician say he is concerned about the increasing number ..  	not_flu
@eammon Don't live in fear. Yes, you could get the swine flu. You could also wreck your car every time you get in it.	not_flu
@mmh1 Pfft! I don't have the flu--I've had my shot. Therefore there's nothing to worry about. :-P	not_flu
Heading out soon for a flu shot and a follow up at the oral surgeon. Getting older is a treat. Or is it a trick?	not_flu
RT @ericrumsey: Scientists in Midwest Examine Pig Farming for Answers on H1N1: Farmers Worry #Swine #Flu (WaPo) 	not_flu
BIRD FLU NEWS Where to find seasonal flu vaccines (source: wtopnews.com) 	not_flu
Mall Santas Fear Swine Flu - Holidays News - Holidash: 	not_flu
Getting a flu shot so my wife can stop hassling me about it :)	not_flu
Starting today, New Yorkers concerned about the H1N1 flu will be able to consult a reg nurse by calling 311 info line: 	not_flu
Had my swine flu shot yesterday, now my coughs sound like oinks, should I be worried?	not_flu
Mall Santas are worried about catching swine flu from snotty nosed brats who spread germs like cockroaches. They're taking precautions.	flu
Mass flu clinic this week doesnt even know 	flu
hmm kids r fattest ever, lowest vitamin D ever, getting hammerd by pig flu, and spend most time in front of a screen of some sort..	flu
Wats the difference between swine flu and bird flu? (Dislcaimer this joke is wack)	flu
Fear the flu? Some answers here  	flu
Footballers Warned Against Spitting As Swine Flu Fear Thickens 	not_flu
Is everyone getting the N1H1 flu shot?	not_flu
Worried about the H1N1 Flu (aka Swine Flu). Go straight to the source for the most accurate information - the CDC's... 	not_flu
Senate moderates voice concern over public option     (AP)Swine Flu Updates! 	not_flu
everyone's getting sick...the 	flu
I'm glad the swine flu epidemic has so many people worried.  It makes skipping class a lot easier.	not_flu
People, stop getting sick! I know 5 people who 	flu
Carlo Ancelotti not concerned by swine flu outbreak: Business as usual says Blues' boss… 	not_flu
Steping outside house to go for a lil drive with dad. One small drive for me. One giant drive for getting over the flu.	flu
1.5M per day getting swine flu vaccine in China - The Associated Press: Albany Times Union1.5M per day getting .. 	not_flu
Also could this virus have been related to the bird flu? Can we trust world -widegovernments to tell  the  truth!!!!!!!!	not_flu
getting my regular flu shot today but not the H1N1	not_flu
Swine flu jab link to killer GB syndrome: Leaked letter reveals concern of neurologists over 25 deaths in Ameri.. 	not_flu
Omg! I'm never getting another Flu shot or the Swine Vaccine!! You can end up not being able to walk!!! How deee 	not_flu
My daughter has developed the flu so I'm home with her.  I'm thinking of putting on 'Star Wars' so I can make a joke about R2D2H1N1.	flu
just got swine flu injection. kinda nervous about this	not_flu
the bird flu endemic in the world 	not_flu
newStream ©: Why bird flu has not become a pandemic 	not_flu
Mall Santas Fear Swine Flu - Holidays News - Holidash: 	not_flu
News Story 	not_flu
Dr. Sanjay Gupta is full of crap. I mean what kind of doctor are you if you can't even avoid getting swine flu?	flu
#swineflu 'Tis the season for swine flu, and Santa is scared - Tampabay.com: CTV.ca&#39;Tis the season.. 	not_flu
SWINE FLU NEWS 1.5M Per Day Getting Swine Flu Vaccine in China (source: New York Times) 	not_flu
Just booked time off to take Finley to one of the H1N1 flu shot clinics here in Ottawa. Long waits but I think it's better than getting it.	flu
with everyone around me getting sick with colds & flu, Vit C is my best friend!!!	flu
First we had mad cow disease, then the bird flu, and now we have swine flu. Holy cow, it's Farmageddon!-Said by a 15 year old girl	flu
@herbadmother Not what anxious fathers like to read either. 12 year old son is home sick with "the flu and a cold", according to his doc. :p	flu
Flu Season: The health department is currently out of the seasonal flu vaccine. We do anticipate getting more. .. 	flu
Dr. Shawn&#39;s Blog » Population and Individual Statistics and A Few ...: For me, not getting the flu vaccine .. 	not_flu
Schoolchildren to start getting swine flu vaccinations next week 	not_flu
RT @MsVBaby: Sooo my car has swine flu KMT! getting ready to go uni late but a mc d's breaky will do =) «woh ori eh»	not_flu
1.5M per day getting swine flu vaccine in China: China's health minister said Wednesday hi..  	not_flu
1.5M per day getting swine flu vaccine in China|China's health minister said Wednesday his country is vaccinating .. 	not_flu
USA Today:  1.5M per day getting swine flu vaccine in China . More #Swine Flu #news - 	not_flu
1.5M Per Day Getting Swine Flu Vaccine in China - ABC News: China's health minister said Wednesday hi..  #swineflu	not_flu
1.5M per day getting swine flu vaccine in China 	flu
New research helps explain why bird flu has not caused a pandemic 	not_flu
RT @AndreaTannouri: Interesting graphic, if you are scared of Swine Flu & need some perspective 	flu
Day 4: Seinfeld, Seinfeld, friends, friends, Seinfeld, Seinfeld, sex and the city, sex and the city....the flu is getting boring	not_flu
RT @fredshadian: 7 Darn Good Reasons You Need Not Fear the Swine Flu: 	not_flu
China health minister says 1.5M a day getting swine flu vaccine ...: 1.5M per day getting swine flu vaccine in .. 	not_flu
Must be getting over the flu. Just got an erection for the first time in several days. Zombie penis lives!!!	flu
@sluggirl I'm actually a little surprised that this campus hadn't already done bird flu planning. I was drawn into that back in IL.	not_flu
Found out that getting the swine flu vaccine is in two different ways for a reason the spray contains live strands 	not_flu
H1N1 Swine Flu symptom worry has Moms doing more for their children&#39;s health: Examiner.com A survey release.. 	not_flu
H1N1 Swine Flu symptom worry has Moms doing more for their children&#39;s health 	not_flu
@Trina_in_RI I will be ur friend as long as u keep the bird flu to urself!!!!!!	flu
Goldman: Flu Fear Spurs Donation! | The Big Picture: (Reuters) New York: Having inoculated its employees with H.. 	not_flu
Why H5N1 didn't cause a pandemic: Via Healthcare Republic.com: Researchers identify why bird flu did not cause .. 	not_flu
Fight away the FLU, make sure you're getting enough VIT D	not_flu
Sitting with the Twitter bird thinking about swine flu.	flu
Swine flu vaccine : like getting a mild flu and a painful left shoulder. 	not_flu
How can you reduce your chances of getting #swine flu?  	not_flu
@Carlisles_Esme_ the hospital is rampant with the flu today so I am afraid I will be occupied much of the day. *big hug*	not_flu
Flu shot 2.0, errands, post writing, and getting ready for the next 2 trips in 2 weeks.  Busy Sunday!	not_flu
RT @tweetmeme 3rd Story – Desiree Jennings Getting Worse, All From Flu Shot! – VaccinationEducation.com 	not_flu
Ala. schools getting nasal H1N1 vaccine: Alabama Health officials say there has been no let up of the swine flu.. 	not_flu
Swine Flu got you down? Thinking about getting the H1N1 Vaccine? I did it! Here's my report http://boyermeetsworld.wordpress.com/	not_flu
Wow just got a shot (no not for swine flu) but damn my arm hurts. And why on earth does getting a shot always make me laugh hysterically?	not_flu
I have this bad gut feeling about getting an H1N1 shot.  Never had a flu shot in my adult life, why start now? (knocking on wood)	not_flu
RT @PhillyInquirer: Student's sudden death fuels fear of swine flu. 	not_flu
Worried About the Flu in Arlington? 	not_flu
GUARDIAN Gary Megson not concerned by threat of swine flu infections from Chelsea: • Bolton have alread.. 	not_flu
RT @boandcharlie: Woman paralyzed after getting swine flu shot in 1976 	not_flu
Guardian &gt;&gt; Gary Megson not concerned by threat of swine flu infections from Chelsea 	not_flu
Most likely I won't be getting the vaccine either. The swine flu hasn't ... (YouTube 	not_flu
plus side of my flu-induced weight loss (and excuse me if this is TMI): no longer any need to worry about wearing a bra.	not_flu
hey, remember bird flu?	not_flu
I can't believe it, but I think I'm getting sick again. I've had more colds / flu bouts this year than I can ever remember having!	flu
Morning!!!!!!! Just found out i have my flu jab 2 day!!!=[ 1 problem i am sooooooooooooooooooooooooooooooooooooo scared of needles!!!!!!!='[	not_flu
Backstreet Boys Show Us the Meaning of Getting Swine Flu - E! Online : 	not_flu
Worried about my babies getting swine flu, or the regular flu, or sick period!  ... 	not_flu
POULTRY NEWS: BIRD FLU: India Declared Free of Bird Flu: GLOBAL - Summary of Bird Flu / Avian Infl.. 	not_flu
Political fallout is seen with swine flu: By DAVE HELLING Like anxious doctors in an emergency room, health sys.. 	not_flu
Political fallout is seen with swine flu: By DAVE HELLING Like anxious doctors in an emergency room, health system stakeholders are now t..	not_flu
Indonesia: Two Suspect Bird Flu Patientis Begin To Improve  	not_flu
@jingstri BIRD FLU OVER THE SWINE FLU'S NEXT #obamamovies	not_flu
Wow!!! Never having to worry about getting the flu again or suffering from migraine headaches, sinusitis, anemia, .. 	not_flu
is nursing a mini migraine after getting the H1N1 flu shot yesterday... oh joy... blood vessels behind my eye are pulsing...  :(	not_flu
worried about Swine Flu  	not_flu
RT @undagroundmilli @KenyaBell Hi Kenya.  I just got over a little flu bug.  Hope you're not getting sick.	flu
@Alyssa_Milano the is good tweetment for me - I think I have the bird flu.	flu
Post: The OEs Blog - Swine flu a concern for Santas this year 	not_flu
RT yes getting her the flu and h1n1 shot  @FatherWizard: @cdanigirl She all right ?	not_flu
Wow..soo the flu shot may put you at risk for H1N1 -&gt; will you be getting the flu shot this year? 	not_flu
New blog post: News: Drug counterfeiters bank on peoples' fear of flu 	not_flu
H1N1 Flu Update: Better Not Cough! Santas Want Swine Flu Shots: Santas across the nation worry .. 	not_flu
why does my arms feel really sore. Is it due to me getting my swine flu and seasonal flu jabs or is it swimming 35 lengths?	not_flu
I hate getting flu!! My nose's clogged and I can hardly breathe!!..	flu
Fluheadlines UK 'Rejects' Swine Flu Jab: It is said to be because they fear side-effects or think t.. 	not_flu
Are you pregnant and concerned about swine flu? For information and advice on how to protect you & your baby go to 	not_flu
@Saramaria I'm just getting over being so sick, I think I had or have the flu :(	flu
Attention Paranoids! The new virus to fear is no longer the "Swine Flu", now it is the "Rhino virus".	not_flu
RT @repgregwalden 	not_flu
@myriadian and have me personal space invaded? In this age of Super swine-bird-hamster flu?	flu
Getting the H1N1 flu shot today and reducing mercury intake. So long, and thanks for all the fish.	not_flu
Worried About the Flu? Get Your Juice! #health #drink #distributor #nurse 	not_flu
Bird Flu News: Asuragen enters into an exclusive agreement with Life Technologies: Asuragen, Inc... 	not_flu
Sometimes the viral nature of the Internet is great. Other times, it just spreads a mistake like a bad case of bird flu. ARGH!	not_flu
Worried about H1N1? Check out "Swine Flu, Round 1" by Pulitzer Prize winning author Larry Wright 	not_flu
@KiaraSlytherin *laughs as magical birds flutter around her head* If you don't get an Outstanding for this, someone's getting the bird flu!	not_flu
Getting over the flu ! Have a killer mirgraine that wnt go away  ... 	not_flu
India declares itself free from bird flu	not_flu
@gingercara I'm not getting either flu shot either and neither is my son. Docs can say they don't cause autism all they want. I don't believ	flu
@GuardianOfGaia Thanks for the wishes.  My doc says it's nothing I really have to worry about.  Just to tough it out like any other flu.	not_flu
@42bkdodgr hi Charlie - thinking I might have the flu...:-(	flu
So many people are getting the swine flu, a 14 year old girl in my county just dade from it. =(	flu
everyone is fighting and screaming and to top it off im sick! im scared that it might b swine flu!	flu
If H1N1 joins with the bird flu, pandemic may be much worse - The China Post 	not_flu
@KeenSilva BIG BIRD FLU	not_flu
RT @SusanDelacourt: Prime Minister Stephen Harper will be getting his flu shot 	flu
RT @mercola:AVOID GETTING FLU by NOT smoking. It dries out nasal passages & paralyzes cilia,the small hairs that helps.. 	flu
215 kids adbsent from my school today 45 went home early and 14 teachers are out. this swine flu thing is really getting out of control!	flu
Not worried re: Swine Flu but worried about travel to Mexico because of gang violence? Don't be!  	not_flu
if you have swine flu, you get oinkment. if you have bird flu, you get tweetment :)	not_flu
More 'at-risk' people getting swine flu shots 	not_flu
Getting my swine flu shot this week. And you?	not_flu
@HeathBar6 dont worry not got the pig flu yet this is my tummy	not_flu
am i crazy for getting excited for a hypothetical party where i would contract swine flu?	not_flu
I don't see myself getting a flu shot. You?	not_flu
Tonight I have my diary frickers since getting over swine flu. It's important to enjoy the little things in life.	flu
RT @tweetmeme We need a swine flu newsroom-concerned citizen 	flu
@phdinparenting So that's a 0.01% chance of something going wrong, compared to around 25% chance of getting flu #H1N1	flu
@adam1975 I am recovering from gastro I picked up in India, and I think I have bird flu to keep it company.  Not feeling well at all.	flu
@musingsfromme Not planning on getting the shots.  I haven't ever gotten flu shots for myself or my family.	flu
I'm worried that I'm getting bitterer. Bad two months: hamster and moochy pooch deaths, mumps and swine flu really fuck a girl up.	flu
RT @lissnup: RT @manic77: Farsnews: Because of the Swine flu #13Aban demo can be cancelled #iran #iranelection | = regime TERRIFIED!	not_flu
flu bug is getting to me... nyquil time!	flu
Explanation of nervous responses to flu fear.  	not_flu
@ThisIsTigger Sorry for the 6 days late reply, I'm worried I could get the flu from Elaine's laptop o.o" Please accept this *gives a steak*	not_flu
R U worried about Canine Flu H3N8 or considering getting your pet vaccinated? DM us if you live in the Madison-area.	flu
Concern grows over flu as wait for vaccine continues 	not_flu
Million Hit by Plague Worse than Swine Flu: Sunday Express | A deadly plague could sweep across Europe, doctors fear... 	not_flu
Individuals who are spreading rumor, and fear about the swine flu injection ought to knock it off!	not_flu
Getting the swine flu vaccine. yayy	not_flu
"The Facts On Swine Flu" - MUST READ! and PASS ON! to people thinking of getting vaccine: 	not_flu
@lene477 don't worry i don't have swine flu they have already ruled it out. i might have rat or mouse flu though :)	not_flu
Colleges fear students' partying will spread swine flu like wildfire (source: New York Daily News) 	not_flu
Just getting over the flu.	flu
Concern grows over flu as wait for vaccine continues 	not_flu
Concern grows over flu as wait for vaccine continues 	not_flu
Concern grows over flu as wait for vaccine continues 	not_flu
Don't be so afraid of the flu this year.  I caught it in Europe.  Used my Germ Blaster and Germ Shield and everything was fine.	flu
Kevin Costner Scared of Swine Flu 	not_flu
@AmishPrimitives Did you know Obama's kids are not getting swine flu vaccine?	flu
Getting the flu story right 	not_flu
Bayern Munich striker Miroslav Klose clear after swine flu fear - Europe: By Soccernet staff Bayern Munich stri.. 	not_flu
#SwineFlu #H1N1 #News Bayern Munich striker Miroslav Klose clear after swine flu fear - Europe:  	not_flu
Dont fear swine flu vaccine (The Cambrian)|While watching the HBO miniseries about the life of President John .. 	not_flu
Swine flu a low concern as Santas invade malls for holiday photo ops: VANCOUVER, B.C. - When Santa comes to tow.. 	not_flu
@seriouslysteve i think im getting the flu :/	flu
In bed with flu today, meditating on God's attributes in Mary's song-Luke 1:46-55. Thought: Replace worry with Worship-creator of universe!	flu
getting that slime flu shot soon	not_flu
Fluheadlines Company Provides Updates On Latest Developments In Flu Vaccine News: Getting the word .. 	not_flu
Fear the flu? Some answers here  	not_flu
HA! RT @someecards: You seem pretty scared of catching swine flu for someone who's not remotely scared of catching STDs. 	flu
I think I'm getting the flu or something... :-( oh please nooooooo....	flu
@TeachJoanne hon,in any case, if you got it, don't worry, it's just a cold. Symptoms are pretty similar to normal flu, as it's the treatment	flu
Getting my flu shot	not_flu
Nothing like getting a flu shot as soon as u get to work in the AM!	not_flu
got the flu bad, sorry if I'm long getting back to you. Not feeling too good at all.....	flu
Public Reaction to Flu: Controlled Concern: Posted by Tom Lyons The Digital Pitch I thought this piece from Lee.. 	not_flu
Got the flu after getting the flu shot. Wassup with that?	flu
Why I wouldn’t dream of getting or letting my wife get the swine-flu vaccine 	not_flu
News: Postal strike swine flu fear: Doctors fear the postal strike could be putting patients' lives at risk by causing them to miss ..	not_flu
As Education And Income Rise, Concern About Swine Flu Declines ... 	not_flu
RT Exciting News! @ehtforum Swine flu virus could ward off severe illness from bird flu 	not_flu
BIRD FLU NEWS Don't let kids trick-or-treat if they're sick (source: wtopnews... 	not_flu
really scared. i got swine flu symptoms..	flu
Swine flu fear keeps teen hospital volunteers home 	flu
Swine Flu Spreading Widely; Worry Over Pregnant Women: Swine flu is now widespread across the entire country, t.. 	flu
Big wedding today and DC tomorrow for 2 days on business...and I feel like I may be getting the stomach flu. Oh no! Any remedies?	flu
Irony = gearing up to wait in the cold rain with the huddled masses in order to get a flu shot so we can *avoid* getting sick.	flu
Get H1N1 flu shot even if late, advises health officials: KINGSTON – People should plan on getting the H1N1 vac.. 	flu
@spreadingJOY bird flu! Too funny	not_flu
Clinics Adapting Flu Vaccine Plans: LAKELAND | Delays in getting H1N1 swine flu vaccine are causing local clinics, h... 	not_flu
Thinking were gonna do TJs party the weekend after Thanksgiving. (getting kids flu vaccines this week) ... 	not_flu
Oh noes, getting swine flu vaccination in an hour. The needle doesn't bother me, but I have to walk to the doctors, that takes 30mns D:	not_flu
is pretty sure she's getting the flu :(	flu
Flashback: Homeless people die after bird flu 	not_flu
Are you concerned with the flu / swine flu? Read about a natural way of dealing with it: 	not_flu
Does Obama know something about the H1N1 flu shot that you don't? His daughters won't be getting it 	not_flu
Does Obama know something about the H1N1 flu shot that you don't? His daughters won't be getting it 	not_flu
swine flu sucks   but i dont have it so dont worry	not_flu
China says 2 dead after getting swine flu vaccine: BEIJING — China&#39;s health ministry says two people who re.. 	not_flu
@sroxy We'll probably decline it. Regular flu shot? I wouldn't be as concerned, but this seems so "iffy".	not_flu
breakingflunews.com China says 2 dead after getting swine flu vaccine - The Associated Press.. 	not_flu
@BaleBabe66 I am not getting any flu shot especially the swine flu shot with the crap they have in it. They'll have to catch & arrest me 1st	not_flu
@rebecca_glass And they did a study on that and found that most of those people caught the flu at the doctor while getting the vx	flu
Heading To Bed To Relax{Not Feeling Good At All, Hoping To Get Rid Of The Flu B4 I Have Kennedy}[Kyleighs Getting Better, Which Is Good]	flu
SWINE FLU QUESTION: I’m worried about getting the vaccine. Seems like it was made it too quick.	flu
As Swine Flu Shots Begin, Officials Fear Shortage: From the Milwaukee Journal-Sentinel:Mark O&#8217;Keefe O.. 	not_flu
RT @phobongsen This will make you think twice before getting a flu shot. check it out. 	not_flu
Gah getting a chest cold or swine flu	flu
I'm getting quite upset at the media still continuing with the term swine flu. I like price of my pork chops but I feel bad for pig farmers.	not_flu
RT @ianmack Culture of Fear: How The Media Killed the H1N1 Flu Shot 	not_flu
H1N1 National Emergency: Time for Concern, Not Panic: Obama declares the swine flu epidemic a major federal pri.. 	not_flu
Hubby might have swine flu. Soo scared!!	flu
HIGH SCHOOL STUDENTS -Concerned with Swine Flu? 	not_flu
I really don't like getting "Focus on the Flu" emails from my work, when all I want is my flu shot. They dropped the ball on this one!	flu
Hello! Contrary to worry  I have not passed away with swine flu. Still grim but not as grim. Thanks for the #ff's. Hear new Curb is great.	flu
Season flu vaccine shortage prompting concern - Montana's News Station 	not_flu
Technology News: Web 2.0: Flu Fear Goes Viral on the Web 	not_flu
Fear the flu? Some answers here  	not_flu
getting over the flu.	flu
B4 U send your kids 4 the Swine Flu shot C if U buy the excuse Gibbs gives 4 the Obama kids not getting it. I sure dont 	not_flu
65 % of parents won't be getting the swine flu shot for their kids, or themselves. They're looking at alternative medicine 	not_flu
A reason to consider NOT getting the #swine flu shot: 	not_flu
RT @BrianNeudorff: Thinking I should be either the H1N1 flu or vaccine for Halloween. B the vaccine, it's much rarer!	flu
British swine flu kids 'scared witless' when French police turned up in masks: A school trip to France ended w.. 	not_flu
Swine Flu: Is anyone else scared about this. I am because TJ has asthma and well we know Skye. She caught Mono... 	not_flu
I was turned down for swine flu vaccine :o(  Darn, and I can't find anyone to administer it to me.  I don't cherish getting sick.  ugh	flu
@blakeshelton how does that keep you from getting the flu?? cuz no one will come near you? LOL ;)	not_flu
	not_flu
US funds bird-flu prevention media campaign (	not_flu
Swine Flu - How worried are you? - Take our poll now and check out how others feel! 	not_flu
Me and my 6 month old baby were exposed to the swine flu 2 days ago. What are our chances of getting it? 	not_flu
RT @mediaeye:1 in 4 people will die from cancer, but 1 in 8,000,000 will die from swine flu. I think I will worry about cancer than a flu!	flu
not getting the free swine flu vaccine.. all I can think of is I AM LEGEND	flu
Vaccinations against flu proving to be hard sell.Officials fear vaccine fears could make epidemic much worse...	not_flu
Swine Flu, H1N1, Update: &#160; Do you really have to worry about H1N1, Swine Flu? Where is the infamous..  Pls RT	not_flu
@ the clinic, waiting for my turn to get a flu jab. Mad scared. I may cry like a baby inside e room.	flu
An added benefit from getting the flu and  sleeping for 48 hours straight? The joy of posting fb and twitter updates at 3:12AM....	flu
Boisterous, ribald and ultimately ridiculous: Bird Flu Over the Cuckoo's Nest. #unexpectedbooksequels	not_flu
Insufficient hospital ventilators for everyone with swine flu. I will be getting my kids vaccinated @ PromptMD. http://bitURL.net/?hffck8	not_flu
New post: Valley's high-risk patients getting swine flu vaccine - AZ Central.com (	not_flu
RT @ZnaTrainer: RT @followdavid: Must Watch: Amazing interview @John_Di_Lemme: Don't catch the Fear #Flu in ur business 	not_flu
Swine Flu vs Bird Flu vs Zombie Flu 	not_flu
Hi-tech holy water calms flu fear 	not_flu
now has numb arms, and thinks that flu jabs are like getting punched.	not_flu
New post: Flu and Recessions: Fear and Reality Catalysts That Affect Commercial Real Estate (	not_flu
I'm tired of Italian news, only talk about useless things and continue to put fear with this flu A  that is just a simple flu!!!!!	not_flu
Swine Flu, Fear and the Middle Ages: parallels in responses to epidemic events 	not_flu
Oops and we all were thinking we r worst affected..RT @HeadlinesIndia 22 million Americans hit by swine flu, 3,900  (cont) 	not_flu
@SubDisposition I have adverse reactions to flu shots, so I will not be getting one.	not_flu
I worry about David getting the flu. I hope he got his shots. he meets so many people	flu
Is still getting over the flu. :(	flu
@mickmusing 3 yrs ago Chinese calendar cow=MadCow, 2 yrs bird=Avian Flu, this yr pig=Swine Flu, Next year? the Cock ... you guys worried	not_flu
@splatnuk Faking the flu will be easy. Coming back because everyone's afraid you have the swine will be the hard part.	not_flu
Swine Flu Found in Household Pets: We now also have to worry about keeping your pet healthy. Earlier this week .. 	not_flu
@sj39 Hey there...just getting over the flu. I haven't been out to church and I MISS IT. I pray you have a full recovery.	flu
Thinking about getting either an Asus EEE or a Dell Mini 10. Can't decide, need help! Someone cure my sister's flu so she can help! :P :)	not_flu
OK WOA! Time out.  Wasn't expecting 2 start getting sick 2 my stomach 2day!  Noooo!  Let's hope it passes quickly! (Got a flu shot already.)	not_flu
Liberals are far more LETHAL than any FLU! Get inoculated before their lying-lies seep-in & cause u to stop thinking clearly. #tcot	not_flu
Practice "abstinence" to avoid getting the "Swine Flu"....	flu
People are tweeting rubbish about Swine Flu - you only know you have it by getting the test - other virus infections can appear similar	flu
RT @photo_b: 	flu
Dillon has the flu and a 100.5 temp. Hope it isn't Swine. Now to keep me from getting it and not being able to go to the hosp. to see Betsy.	flu
New Wizbang post!: Obama Revs Up The Swine Flu Hysteria: Here comes the fear-mongering: Pr.. 	not_flu
authories fear merger of swine to bird creating the super-flu	not_flu
Don't buy into hysteria created by media about swine flu. Fear of illness and death was promoted by media in 1917-1919 flu pandemic also.	flu
Thank u every1 Ella is on the high risk list so she's getting that the flu shot and hep a - we're gonna wait on the mmr	not_flu
RT @JaylaStarr: wow t-boz had the swine flu!!!! wtf??-- man I'm scared I have been washin the shut outta my hands!!! Fuck that!!	flu
RT @dabreakradio: RT @talkhani: mad cow, sars, bird flu & now swine..so whats next? &lt;caterpillar clap	not_flu
New Book: Dread: how Fear & Fantasy Have Fueled Epidemics from The Black Death to Avian Flu. RA 649 A43 2009. Rev ed to include h1n1??	not_flu
Wife got her swine flu vaccine yesterday. She had to leave work early today because she was getting sick. Hmm...	not_flu
Getting over flu - just had 1st proper meal since Tuesday night. James got me some extra strength paracetamol with caffiene, they've helped!	flu
RT @DeborahJHendrix: Do you know ANYONE who has trouble getting treatment for swine flu if they get it? That is their argument.?NO NO & NO!	not_flu
@TrendingTashics thats so scary....no way am i getting the flu shot	not_flu
Can't believe some women still don't wash their hands after using the bathroom. Hello! SARS, Bird Flu, H1N1....Seriously?	not_flu
For Children With Flu, a Trip to the ER?: Evan Abramson for The New York Times Many anxious parents wonder whet.. 	not_flu
The difference between bird flu and swine flu. With Bird Flu you need a tweetment, and with Swine Flu you need an oinkment.	not_flu
Everyone in my family is getting sick! ugh. getting the swine flu shot tomorrow... then spendin a couple days with  ... 	flu
Scared of pig flu digging out my bubble 2 live in	flu
The Real Emergency is Fear Mongering: RT: @BreakingNews President Obama declares the H1N1 swine flu outbreak a national emergency.	flu
RT: 2007 yr of the cow, Mad Cow. 2008 yr of the bird, Avian flu. 2009 yr of the pig, Swine flu. 2010 year of the cock. Anybody else worried?	not_flu
New bird flu outbrk worries officials: H1N1 pts could contract bird flu, virus could mutate, evolve into new supervirus 	not_flu
@anton1690 Damn that sucks... Regular flu or swine?   U know we got that Goat flu floating around this bitch :nervous: lol	flu
NYT: Swine Flu Spreading Widely; Worry Over Pregnant Women For more: 	not_flu
Was at ER this morning with back spasms. Horrible. Now worried I will get stupid swine flu from being there!	flu
Does anyone else get visions of I Am Legend when they think about getting the swine flu vaccination?	not_flu
Arkansas' receivers don't have to worry about swine flu.... they can't catch a cold.	not_flu
Getting my flu shot on Monday. This is getting real serious. "Obama Declares Swine Flu a National Emergency". 	not_flu
Got my flu shot yesterday--arm's a teeny bit sore today (but not bad at all).  Looking forward to getting the H1N1 swine flu shot next!	not_flu
Longing to read but shoveling papers about. I'm worried about the flu. Should I be?	flu
RT @AFFIONCROCKETT: For all of u contemplating getting the swine flu shot.. just know that THEY'RE INJECTING U .. 	not_flu
RT @xoix RT @acidnews Health officials worried about unpredictable aspects of #H1N1 flu - @VancouverSun 	not_flu
I'm NOT taking the Vacs. & would advise others not to either. I would be more scared of the vacs than the swine flu itself!	not_flu
Video of a bus ride and folks getting flu shots yesterday: 	not_flu
When I get over this cold I'm getting a flu shot!	flu
@timeavida I know I'm so scared I'll get the swine flu. I'm getting my swine flu shot today. I'm so relieved!!!!	flu
RT @LaBellaGABY: Obama declares Swine Flu as a National Emergency?! Uh-Oh =O -- Fear Tactics	not_flu
ALERT -  Seasonal Flu Shots Dangerously Scarce: Physicians nationwide fear there are not enough regular flu shots .. 	not_flu
What do you think about the safety of the swine flu vaccine? Media hype or reson to worry? 	not_flu
God, Obama's declared swine flu is a national emergency. I'm a bit scared.	flu
oh no.. oh nooohoo.. in 1 hour i am getting swine flu injection :|.. people say it hurts.. people say you become sick of it.. im nervous :|	not_flu
RT @MaxLucado: For the bird flu you need tweetment. For the swine flu you need oinkment.  (via @mommyinstincts)	not_flu
Thailand&#39;s North alerted of bird flu outbreak 	not_flu
@thokay I send you lots of kiss&smiles! :-x (-: recover soon! Me too, I am not afraid if the flu!	flu
RT @eniac: Swine flu concern - I’m not really concerned about swine flu.. Here’s my concern. 3 years ago, 	flu
I am just getting over the flu (not H1N1). Wish I considered these tips a few weeks ago: 	flu
@ChitaHearse I'm not getting the H1N1 vaccine - remember the last swine flu vaccine??? No thank you.	flu
Getting swine flu shot -	flu
CBS Reveals that Swine Flu Cases Seriously Overestimated: Dr. Mercola &#124; The CDC continues to use fear to m.. 	flu
i'm getting a headache. BETTER NOT BE SWINE FLU	flu
@xmeow -- U R so right. You should see the fear-mongering on TV in the States - Everyday trying to scare us into buying vaccines flu meds.	not_flu
RT @InFamOusAnGeL damn swine flu killed 4000 ppl already &lt;~are yu scared causr yu sick (God forbid )	flu
Atlanta (GA) CBS46: Flu Vaccine Arrives, But Who's Getting It?. More #Atlanta #news - 	not_flu
Seasonal Flu: Does It Increase The Risk of Heart Attack? There's disturbing evidence that getting the seasonal flu can increase your risk of	flu
News:: Hi-tech holy water calms flu fear 	not_flu
@mojohnny we're all fine/ getting over ?swine flu or some other raving lergy. Felt like poo at w/e but beer, curry & singing helped i think.	flu
And I thought I beat it after 3 other people in my family getting sick...but I didn't.  I'm now sick with the flu.  No Guinness for me!	flu
@thurtinkle Oh don't worry, there's a lot of it around at the moment. Like the flu. :-) x	flu
I'm tired hearing about the swine flu. Can we bring the bird flu back in it's place? That was an exciting flu.	flu
SFGate| Catching swine flu in a restaurant:  Concern about swine flu has hit the restaurant world har.. 	not_flu
Getting my science hat on w/ this site comparing the relative size of 12ppt font, e.coli bacterium, flu virus, etc. Tiny! 	not_flu
swine flu shot tomorrow......im nervous even though my sis got it monday and is find...... but stilll ugh!!	not_flu
If you are worried at all about swine flu then take a peek here: Click Me for Health Now 	not_flu
is scared of hearing so many cases of swine flu in the area.	not_flu
RT @nationalpost: If bird flu, H1N1 or Y2K didn't get you, the asteroid will 	not_flu
If bird flu, H1N1 or Y2K didn't get you, the asteroid will: Even before swine flu hysteria comes to an end, mom.. 	not_flu
@siovene Love todays geekhero. Don't we all fear windows users with swine flu?	not_flu
Will flu fears make us stay home for the holidays?: By Tom Wharton Utahns may be concerned about the worldwide .. 	not_flu
Ahhh, same here @Naturally_Flyy! I got my #H1N1 & flu shot, then came home & curled up wit my boo! haha it's getting sooo cold! #naturalhair	not_flu
@Cazabellaroo Argh swine flu! So getting my vaccine now! Hope you feel better soon oh wonderful one, sending you lots of healing love! &lt;3	flu
And made Little Man's 2 yr doc appointment. Got both kids in for the flu shot...only both are getting H1N1 & Hopkins is out of seasonal	flu
@TheMurphy the swine is here, but I don't think it will be as bigger deal as the media portrays, just look at cjd and bird flu hysteria!	flu
I didn't get the shot out of fear! RT @DustinRussell RT to show you aren't driven by fear: I didn't get a swine flu shot & I feel just fine!	flu
I hope those cowboys catch the bird flu from the falcons!	not_flu
Lots of co-workers getting the "piggly" as @scjudd calls the Swine Flu...  and he's one of them...  I cannot get sick now.......	flu
What is difference btwn swine flu and bird flu?  For bird flu you need tweetment and for swine flu you need oinkment...Follow Friday!	not_flu
@KStackz Cut birds off Ur gonna get bird flu Even if u puttin her on hold. Don't matter as a man u have 2 know when 2 clip UrGrown sheAint	not_flu
@DippyDolittle That's wise. And maybe a Bird Flu jab.	not_flu
I am not getting a Flu Shot!!!	not_flu
Yo. I'm getting a flu shot! :D	not_flu
Another breast augmentation today in Santa Barbara, and then some new patient consultations.  Getting a flu shot too!  SBplasticsurgeon.com	not_flu
Another breast augmentation today in Santa Barbara, and then some new patient consultations.  Getting a flu shot too!  SBplasticsurgeon.com	not_flu
Another breast augmentation today in Santa Barbara, and then some new patient consultations.  Getting a flu shot too!  SBplasticsurgeon.com	not_flu
@dannywood oh man!! I would love to go...in the middle of a pandemic flu, no rest for us Public Health Nurses :( I'll be thinking of you!	not_flu
Oh great. I go to bed cranky as fuck, then wake up to find out im getting the flu. Life loves me.	flu
Kinda scared now. Poor austin has the flu! And hes really bad. I hope he gets better soon!!! Get well! Miss U! ... 	flu
Swine Flu curse you!!!! So many people are getting sick!!!!	flu
RT@ sengels_ RT @dreamslikefire: Swine Flu paranoia is getting out of hand.. 	not_flu
Thinking of getting the flu shot or H1N1 vaccine? Check out the history of Vaccinations in this long excerpt: 	not_flu
@bilerico my niece was in the ER 3 hrs this morning getting tested for flu & waiting for a scrip. It's heinous. Hope Jerame gets help soon!	flu
RT @jaruzek: I am not getting a flu shot again after seeing this: 	not_flu
I'm tired of hearing about this swine flu to the point that I couldn't less about it unless someone I know has the swine flu, then I worry	not_flu
iam scared to take a flu shot after seeing that shit	not_flu
wonders with the current flu season if its wrong to lick my hands before shaking hands with people.  Getting some interesting looks though.	not_flu
Not to impugn a sick bird, but perhaps it just has bird flu.	not_flu
co-worker that sits 2 desk from me came down with swine flu. 2 others on team are home sick. i'm worried.   :-(	flu
3 yrs ago, Chinese year of the cow-Mad Cow. 2 yrs ago, year of the bird-Avian flu. This year, pig-Swine flu. Next year is year of the cock	not_flu
3 yrs ago, Chinese year of the cow-Mad Cow. 2 yrs ago, year of the bird-Avian flu. This year, pig-Swine flu. Next year is year of the cock	not_flu
The approach of winter and flu has you worried? Worry no more Click Me for Health Now 	not_flu
Feeling worse than ever. Fear this is actually the flu. Unsure if it's worthwhile to see my doctor for a formal clinical diagnosis.	flu
	not_flu
Deeply, deeply disturbed by chapter 4 of Michael Greger's book Bird Flu www.birdflubook.com	flu
RT @joetech: Swine flu fears getting out of hand. [pic]  	flu
#ff @jasonmhines for compliments, @tdas for having "swine flu", @mausam86 for fixing the window and getting rid of the mouse.	flu
[BMSN] Will you be getting vaccinated with the Flu or Swine flu shot this year? 	not_flu
POLISH HEALTH MINISTER EXPECTS H5N1 BIRD FLU 2010 	not_flu
Omg swine flu has hit my hometown!! I'm scared to go home this weekend!!	flu
Swine Flu vs. Bird Flu vs. Zombie Flu - Medical Transcription Schools - 	not_flu
@RobThomasPatt  So true! I am hibernating so I don't get the flu!  Will you be getting any time off at all? I'm still willing to hide u! Ha!	flu
Just saw the old robot chicken where Big Bird gets bird flu. What r the chances of that happening today?	flu
Swine Flu - How worried are you? - Take our poll now and check out how others feel! 	flu
Bird flu and other unexpected changes in Vietnam's food chain and diet have sparked a rodent-eating bonanza. Now, the ratatouille comes	not_flu
Worried about having a cold, regular flu or swine flu? What's the difference in terms of symptoms?  Read this: 	not_flu
RT @pam3la: In other news, tomorrow is MINI FRIDAY! YAAAAY!  I'm getting a flu shot & my hair cut...finally. /Today for me, tomorrow holiday	not_flu
@BeachHut81 trying to recover from this awful flu. Just about getting there now!	flu
@Carltoncuse: pets are getting swine flu, here's my money-making idea:  Purell pet mat.  Dogs and cats step on it on their way in the house.	not_flu
Thinking we may need to just pile all the Mansion kids in one room. All get flu at same time. Get it over with. Just kidding.	not_flu
This year, Chinese calendar year of the pig .... swine flu. Next year is the year of the cock .........Anybody else worried?	not_flu
Fear of H1N1 Flu May Spark Anxiety Among Students: A GoodTherapy.org News Headline The symptoms of the so-calle.. 	not_flu
Getting a flu shot this fall? Canadians scientists have found that focusing on a pretty image could alleviate t.. 	not_flu
At least I may have some immunity if the 'pandemic' arrives...sort of a head start eh? Then again, fear 	not_flu
Just curious?? Are u getting the swine flu vaccine? #fox5	flu
I'm getting a flu shot for the ones I love - especially this season. You should get one, too. Pass it on. 	flu
@AnaHotaling The flu is just the body getting rid of acidity ..people die because the medical profession brings them in & gives more acidtiy	flu
RT @News_SwineFlu : #swineflu As swine flu shots begin, officials fear shortage - Milwaukee Journal Sentinel 	not_flu
BIRD FLU NEWS Cyber Exploring The 'Ecosystems' Of Influenzas (source: Science .. 	not_flu
PIG AIDS! #swineflu As swine flu shots begin, officials fear shortage - Milwaukee Journal Se.. 	not_flu
Fear of H1N1 Flu May Spark Anxiety Among Students: A GoodTherapy.org News Headline The symptoms of the so-calle.. 	not_flu
I'm going to get the flu shot, because getting a shot isn't as bad as getting the flu.	not_flu
@Kaycitapia swine flu vaccine AND TB skin test. I ended up getting two :(	not_flu
Are you or a loved one sick and worried you might have H1N1 Flu? Check out this H1N1 Flu Self-Evaluation link 	not_flu
headache from hell, man flu is not getting on this bus	not_flu
Leona Aglukkaq is outraged Taliban prisoners are getting the swine flu shot. @5:30 why NOT giving it could violate the Geneva Convention.	not_flu
@Fabviid Don't play into the hysteria.  Be proud of NOT getting a flu shot, like me :-)	not_flu
New Diggs: Ten Swanky Swine Flu Masks (Pics) - This flu season, with the swell of H1N1 hyping up fears of getting s... 	not_flu
Ten Swanky Swine Flu Masks (Pics) - This flu season, with the swell of H1N1 hyping up fears of getting sick, pedest... 	not_flu
Scared About Swin Flu? Check This Out - The Ultimate "Health Newbie" Cleanse Program - Click Here---&gt;http://rainforestdetox.com/	not_flu
FLU FACTS -  What Is Bird Flu? 	not_flu
Are You Getting the Swine Flu (H1N1) Vaccine? Free-Clinics Open Tomorrow for Priority Groups 	not_flu
Ten Swanky Swine Flu Masks (Pics): This flu season, with the swell of H1N1 hyping up fears of getting sick, ped.. 	not_flu
Whats the difference between bird flu and swine flu. Bird flu u use tweetment and Swine flu u use oinkment	not_flu
Fear Over Swine Flu Closes Schools in Iraq (International Herald Tribune): Fear of the H1N1 virus has prompted .. 	not_flu
this is CRAZY! i'm never getting a flu shot everrrr 	not_flu
breakingflunews.com No proof swine flu is getting deadlier despite death toll - WalesOnline:.. 	not_flu
Worried parents stalk the elusive swine flu vaccine: It&#39;s a scene out of &quot;Willie Wonka &amp; the Choco.. 	not_flu
Educate and Prevent No proof swine flu is getting deadlier despite death toll - WalesOnline:.. 	not_flu
Google Offers Map Showing Off Where To Get Flu Shots: Worried you won't be able to get a flu shot?.. 	flu
Live Blog: Swine Flu Update from CDC Chief - Americans started getting vaccinated against the swine flu yesterday. ... 	flu
Are Our Pets Really Getting the Flu? -Yeepet.com Blogs -: 	flu
Great turnout for FarmMarket talk: "The Flu, Vitamin D and Boosting Your Immunity" last Sunday. Getting ready for December 8th talk.	flu
Daily FAIL! p7 'This is all the politics of fear at it's worst' Front page headline 'Swine Flu Cases Double In Week' FAIL! FAIL! FAIL! o_O	flu
getting a flu shot and thinking it is not too smart to be in this long line with all these iffy people	not_flu
So the Sniper getting a permanent flu shot tonight if you from the DMV and lives thru this horror dont fret he getting off easy!	not_flu
White House concerned about flu spreading in churches: 	not_flu
new #Google service to find more easily locations near you for getting both the seasonal and #H1N1 #flu vaccine 	not_flu
Getting the swine flu vacine after much deliberation. On a related note, the clinic is rt nxt to my old JHS, Mark Twain. Ah, the memories :)	not_flu
finally getting flu shot after waiting six weeks to get one	not_flu
• 2 years ago, Chinese calendar year of the bird . . .  Avian flu.	not_flu
Just posted... on not giving a pig’s arse about swine flu: The little red-haired girl is getting over swine flu.  ... 	not_flu
	not_flu
Lessen the spread of flu in your home and your chances of getting it. 	not_flu
Parents fear flu vaccine's second dose won't be availab... - 	not_flu
The approach of winter and flu has you worried? Worry no more Click Me for Health Now 	flu
I think im getting the swine flu....	flu
@kaybreezy24 HELL YEAH!!! That scared me!!.she was young and had just been married got a flu shot and then she can't even walk but backwards	not_flu
Im having my swine flu vaccine on thursday but im thinking of selling it to the highest bidder	flu
SO TRUE!  RT @HarrisonHand: Fear feeds illness. Don't let flu hysteria make you sick.	flu
Mistrust and Fear Over Swine Flu Close Schools in Iraq: Fear of the H1N1 virus has prompted nearly 2,500 school.. 	not_flu
breakingflunews.com Worried parents stalk the elusive swine flu vaccine - Washington Post: W.. 	not_flu
why is everyone getting their flu shots except for moi?	not_flu
@jonesbaby he afraid of getting swine flu? Haha	not_flu
Notice each year, there is a different animal. Last year, bird flu. Next year: elephant flu RT @beinspirednow: .. 	not_flu
Nice 20k bike. Thinking about Remembrance Day tomorrow. Thanks to Public Health Advisory of Canada for investigating vit.D as flu prevention	not_flu
@sjAimee Colin has gotten sick with both of his so far. I just feel for the poor little guy. Plus he's getting 2nd half of flu shot 2morrow.	not_flu
is headed to the Dr's office..blood work, getting scripte refilled, & that annual Flu shot..The product of getting OLD...	not_flu
Taking the Compact Carrs for their piggy flu shots. I'm so against the idea, this better not make them sick! #fb #worried #hateshots	not_flu
RT @barry_wang: People fear pig flu. Pigs fear wang flu.	not_flu
@JohnnyJet do u get sick a lot?  I get sick 1x year & never get a flu shot. I'm not getting H1N1 shot either. Take vitamins & wash ur hands	not_flu
I have to take a shot of cough syrup. This coughing is getting to be a bit much. This 2day flu is no joke. At least I hope its 2day flu. :-)	flu
Just a thought: With the #Oilers being hit by the flu bug, why didn’t Ken Lowe do his homework before the season by getting flu shots?	flu
@drkrauza why what does it say? kind of nervous about the swine flu vaccine as the news said my gf should have it	not_flu
RT @kingotnw: @B_Twice unless you're a little kid or getting way up there in age there is no reason to get a flu shot!  Still don't need it	not_flu
getting my flu shot	not_flu
reads: Snifflers, sneezers becoming targets of people who fear catching swine flu: As the new flu spreads.. 	not_flu
Are you worried about whether your child will be able to get a swine flu vaccine in time to prevent infection? DM me your thoughts.	not_flu
RT @RightWingNews: Guess Who Is Getting Your Swine Flu Shot?	not_flu
I'll likely wait FOREVER in the docs office. Is it normal to be terrified I'm going to catch the swine flu while I'm here? Cause I am.	flu
RT @howardtayler: Can we please stop calling it "swine flu?" It's demeaning to the sufferers and provokes fear. From now on, "hogthrax."	not_flu
got a flu shot for the first time ever, worried it will give a me a weird reaction right before i leave for vacay	not_flu
@marrsattacks: Watch this video and think twice about getting a flu shot... Soooo Sad: Girl Crippled From Flu Shot: 	not_flu
FOXCharlotte Update Santa & Swine Flu: Malls are getting ready for the lines of kids and the.. 	not_flu
RT @edu_tweets Swine flu v. Bird flu v. Zombie flu 	not_flu
I sneezed! Oh no! Im getting the swine flu!	flu
Blog Post: How does getting a seasonal flu shot increase your risk of getting H1N1? http://swineflustart.com/?p=100	not_flu
Bird Flu?! yikes! RT @iceburghNHL: Or worse, bedbugs!	not_flu
If you are worried at all about swine flu then take a peek here: Click Me for Health Now 	not_flu
That green Tea helped my Bird Flu a lot	flu
this is what hapens to people who get swine flu shots 	not_flu
Go to mrsimcard.com 15% of inmates risk getting swine flu - OFFICIALS at Cork Prison have said that up to 15% of in... 	not_flu
Your kids  not sure about getting a swine flu shot? Have them watch this PBS Clip. It will save you a trip to the Dr. 	flu
WTF aren't these flu shots suppose to protect from getting sick smh	flu
I don't do medicine but my neighbor just plugged me wit the flu shot..not tryna get sick..this flu is getting to close for comfort..lol	not_flu
@heykim Stilll fighting health problems. Going through a whole battery of tests. Am worried! In fact typing from my flu bed tonight. :(	not_flu
Getting a flu shot tomorrow, I think. Westminster Secondary School.	not_flu
I'm getting the flu. Is this a joke? /kehlrgo;iajer;'hopiv ou[,h	flu
Think more than twice before getting swine flu vaccine: Sun Star Courier GIs developed arthritis, fibromyalgia,.. 	not_flu
H1N1 clinics start at San Diego schools: Thousands of children in the county are getting the swine flu vaccine .. 	not_flu
@planningforever I mean: far more people die from seasonal flu than from H1N1. If u know what I know. . .not getting the vaccine. . .	not_flu
Please print & post in your communities: The FLU Shot! Know your facts BEFORE getting vaccinated: 	not_flu
Getting my flu shot. I'm probably more scared of the shot than I am of getting the flu.	not_flu
Work then getting flu shots with @MissHelmey and her mom. Ouch!	not_flu
My irrational fear of needles is NOT helping me get my act together and get a flu shot today... :'(	not_flu
@amypaffrath Got my flu shot yesterday. I usually get sick after, but so far nothing-getting sick hits me pretty quick-I'd get it though.	not_flu
Lieberman Grills Feds Over Swine Flu Preps: Grab the tissues, swine flu "may well be getting ahead of the publi.. 	not_flu
@UMHealthSystem ... swine flu strains in 50s, 60s, 70s. That's why we think elders are not getting sick often w/ H1N1 now. #H1N1swinefluchat	not_flu
Flu-fear products offset 3M&#39;s shrinking office supply sales: By Dan Haugen | Published Thu, Oct 22 2009 9:4.. 	not_flu
Getting a flu shot at work involved showing the 15 co-workers in line my nipple. Also, mass vaccinations are probably communist or something	not_flu
Bird Flu News: Presentations on efficacy of interferon to combat influenza: Amarillo Biosciences,.. 	not_flu
Dreading the kids getting their flu shots today!! Gonna be a long day!	not_flu
getting ovr the flu :/	flu
Morning!! One class today then getting a Flu shot and then homework!! Yay me! I hate shots!	not_flu
@AIDigest "Bird flu back in Africa" = recycled news from 2006 #birdflu #H5N1 #news	not_flu
MAN IM SCARED TO GET THE FLU FA REAL LIKE LAST NIGHT I WAS EATTIN CARROTS AND SOME GREEN LEAVES IDK WHAT I EAS EATTIN LOL BUT SERIOUSLY	flu
Where to Get a Flu Shot Is Big Worry of Season: From telephone hot lines to vaccine drive-throughs, the states .. 	not_flu
Getting flu shot and nasal swine flu	flu
Should I be worried that I am showing 5 symptoms of swine flu?	flu
Amazon just told me my copy of Modern Warfare 2 just shipped... I think I am getting the flu and won't be able to work the rest of the week.	flu
britt wasnt exaggerating... They are worried about swine flu at concordia... There is hand sanitizer at every table setting	flu
Swine Flu Frenzy Could Impact VA Governor’s Race: Fairfax County officials worry a planned vaccination clinic c.. 	not_flu
Bird Flu Virus Can Survive Two Years in Landfill 	not_flu
RT @AIDigest North Bengal Bird culling fails, disease spreads #bird flu - 	not_flu
is getting more people worried about "swine flu" - don't stress - it's no worse than a bad cold.	flu
The Flu Blues: Alternative medicine practitioners say you can skip the shot - and still avoid getting sick - wi.. 	not_flu
probably NOT getting the flu shot...	not_flu
First evidence that bird flu is spread sexually 	not_flu
makes you think twice about getting the flu shot - watch this vid. 	not_flu
I'm watching all of the first and second season as we speak @susiekostaras! Its the only thing getting me through this flu.	flu
RT @hollyhav Easy ways to avoid getting the #H1N1 or #swine flu virus: Especially the gargling salt water or Listerine 	not_flu
#H1N1 #SwineFlu #News  Easy ways to avoid getting the H1N1 or swine flu virus:  	not_flu
R @Disneyopolis: Easy ways to avoid getting the H1N1 or swine flu virus 	not_flu
Easy ways to avoid getting the H1N1 or swine flu virus: Examiner.com The above strategies will help arm you aga.. 	not_flu
Easy ways to avoid getting the H1N1 or swine flu virus 	not_flu
Easy ways to avoid getting the H1N1 or swine flu virus 	not_flu
So tweople, I have thought long and hard about this & I have decided: I will NOT be getting the Swine Flu (H1N1) vaccine.	not_flu
Getting my flu shot. Studying all the time.	not_flu
getting over this swine flu... going to school tomorrow i guessssss :/	flu
Wow, all my family and friends in the US now seem to be getting swine flu. Hope they all recover soon!	flu
@courtstothemax I'M NEVER GETTING A FLU SHOT AGAIN: 	not_flu
@urban_elysse yea i need that money lol but i wanted to get a flu shot but im scared that i'll end up wit da flu dnt want dat happenin lol	not_flu
Swine flu? No! Bird flu? No! Bear flu? Now were talking. I bet if they called it poodle flu it'd be loved	flu
@jazzzyone I've never had the flu shot or the flu and I don't plan on getting the shot. Like u said, "I'll just keep washing my hands"	flu
Getting ready for funeral home visit for a dear church member who died from complications of flu	flu
I think I am getting sick. Feels like the Flu, hope its not Bird, swine, Spanish, tasmanian frog or Scottish salmon.	flu
RT: I was really excited about getting sick when I thought it was called "Wine Flu". (via @corycavin)	flu
	not_flu
RT @courtstothemax: I'M NEVER GETTING A FLU SHOT AGAIN: 	not_flu
ok question? who is wanting to get the H1N1 vaccine? I after getting the flu shot twice..refuse to ever get it agai ... 	not_flu
RE:| U better b careful to make sure its not H1N1! Keep me posted! Now im worried!!!! ---------- NkHpTwihard: flu sucks!!	flu
RT @JeanGreasy: Please don't getting the fucking flu shot. Or let your children get the flu shot. Just no flu shots. For anyone. Ok?	flu
@michellepanga I did too. But I'm afraid of catching the flu.	flu
concerned about H1N1 flu? 	flu
getting the swine flu vaccine	not_flu
The approach of winter and flu has you worried? Worry no more Click Me for Health Now 	not_flu
only if well meaning folk continue to fuel fear RT @Holly59: H1N1 Flu: Will history repeat itself? http://bit.l.. 	not_flu
Protect your cats from getting the swine flu via NYT 	not_flu
In line getting regular flu shots with cousin playing tap tap revenge lmao	not_flu
Getting a flu shot for Lev.	not_flu
LMFAO! Aww... Swine flu is getting out of hand 	not_flu
people still fear swine flu 	flu
For those concerned: I don't seem to have a flu, just a nasty full on cold. History TV is my friend today.	flu
Taking flu vaccination tomorrow. OMG! it's been years since I last take a injection :z scared sia...	not_flu
Flu fear fills kids' ER: #Winnipeg's Children's Hospital emergency room has been so overwhelmed over t.. 	not_flu
4 ya'll that cant see tha video this chick got a flu shot and it fucked her nervous system all up she cant walk forwards, only backwards...	not_flu
of to clean the bird feeders and ponder over this swine flu jab for my son	not_flu
Is 2009 H1N1 influenza vaccination safe for pregnant mother ...: Getting the flu shot is the single best way to.. 	not_flu
Doing the right thing and getting a flu shot today.	not_flu
@insomniac4u he's most definitely not getting the swine flu shot	not_flu
I'm not advocating getting the Swine Flu shot but not taking my warning from an Inside Edition story either	not_flu
Is your child getting a flu shot? I'm still on the fence about O getting one.	not_flu
Milwaukee is finally getting a batch of the swine flu vaccine on Friday!! Too bad it is over fall break.... :(	not_flu
had the flu for a week, now i might be getting strep. FABULOUS. fml.	flu
Baxter Sent Bird Flu Virus to European Labs by Error (Update2) 	not_flu
Episcopal Relief & Development                 Getting ready for flu season?  So are we:  	not_flu
H1N1 (Swine Flu) got you worried??- Boost your Immunity system & add energy too! Win Win! Ask me how!	not_flu
Bird flu	not_flu
Thanking the Lord for getting me thru this week-He helped me 2 do well in my training class while having the sinus flu! TGIF! ty 4 prayers	flu
RT: @TannersDad: Chinese Calendar 3yr ago Yr of Cow Mad Cow 2yrs ago yr of Bird Avian Flu This is yr of Pig Swine Flu... Next yr? Yr of Cock	not_flu
Hagan official has the flu. Fever of 101 and he keeps getting sick.	flu
so im deff the only 17 year old who cries and RUNS AWAY when getting the swine flu shot.	not_flu
Just watched the EMA's so i'm happy now.Gonna take a nap now cause that damn flu shot is getting to me &gt;_&lt;	not_flu
Jail Inmates Getting Flu Vaccinations Before Guards: KIRO 7 has learned about a new controversy over what King Count... 	not_flu
@BADSenoritaa me too... I think I'm getting the flu :-(	flu
Fluheadlines U of M expert fears H1N1 flu vaccine will come too late: A flu expert says he's worried.. 	not_flu
@Ms_NuvO awww well get better tho we don't need no more ppl getting the flu	not_flu
Okay, Maybe I'm a LITTLE Nervous About Swine Flu: I wrote a while back (here!) about how I am not afraid of swi.. 	not_flu
Children are worried sick over H1N1's spread: Spread of swine flu among the young &ndash; plus confusion over v.. 	not_flu
RT @noe96743: Mad Cow, Bird Flu, Swine Flu...what is this....FARMAGEDDON?	not_flu
Weird Asia News: Swine Flu Prompts ‘World Hand-Washing Day’ in Japan: The systemic fear of H1N1..... 	not_flu
Are Our Pets Really Getting the Flu? 	not_flu
WHO rejects homeopath concern on flu jab 	not_flu
Definitely planning on getting my flu shot.	not_flu
there is a 99.9% chance ur not going to die whether u get the swine flu shot or not. odds are good enough for me. still not getting the shot	not_flu
Worried about H1N1 (Swine Flu)? Here are some resources for you..... www.cdc.gov / www.co.napa.ca.us / On FB under Napa County H1N1	not_flu
Stuck home with the flu but getting better :D	flu
Worried about H1N1 (Swine flu)? Read our special report for tips on preventing contamination in your home and office http://maidtoclean.com.	flu
@abrandnewday4 flu sick; but i'm getting better quite rapidly; i just ate soup.	flu
@YvonnePalomino dont worry.. its just like the normal flu!!	flu
TIME actually put "I Can Has Swine Flu?" in the name of their article about a cat getting swine flu. I love them so much more now!	flu
Today is a 'big' day,'cause the whole 'family' will be getting the flu shots!!	flu
Im scared of that flu shot yall , iono if i want that shyt , uhhh uhhhh i aint finna die	not_flu
LA Fair with @dmonroy! I'm going to try not to touch anything w my hands for fear of swine flu.	flu
RT @newmediajim: ON TODAY SHOW RIGHT NOW - story about Goldman Sachs and Citigroup getting swine flu vaccine before hospitals	not_flu
RT @newmediajim: ON TODAY SHOW  - story about Goldman Sachs and Citigroup getting swine flu vaccine before hospitals	not_flu
T.G.I.F for tomorrow.. excited to sleep longer  in the weekends =], but getting flu shots too .. well, night everyone =] dam school.	not_flu
@Priscilla143 I would be scared tho. Like swine really? You couldn't hve the regular flu? LOL	flu
Swine flu is so five minutes ago, there's a new vaccine-proof flu we can excessively worry about. 	not_flu
Everyone is getting sick... I hope I don't catch the flu!	flu
The odds of getting sick from the vaccine are higher than getting swine flu!	not_flu
RT @lifeenergymanObama Declares Swine Flu Emergency. Listen 2 this if u r still thinking about getting the jab! 	not_flu
getting sick :| I think ima get the turtle flu lmfaaooo	not_flu
@natesmom10 i got a flu shot day before i started getting sick!  bt i think it's coincidence.	not_flu
What'll happen when Swine Flu crosses with Bird Flu? Will pigs finally fly?!	not_flu
Reduce your chances of getting the flu by taking USANA's Essentials - containing the highest number of antioxidants in the industry...	not_flu
Oh no! Poor kittens are getting the swine flu now, too!	not_flu
Swine Flu Vaccine Priority For Businesses: The top concern for most U.S. business leaders is getting enough vac.. 	not_flu
It's bad enough I have to protect myself against swine flu, but now I have to worry about puppy pink eye.	not_flu
[News] Swine flu is emptying SouthCoast classrooms: By Grant Welker The swine flu — or even the fear of c.. 	not_flu
Wall St Bankers getting priority on Swine Flu vaccine... What???  	not_flu
Unpeeled onions keep you from getting the flu? You read; you decide. 	not_flu
RT @LoveJonesPD: OMG! Have you guys heard about this woman who became sick with Dystonia after getting a flu shot? 	flu
Swine flu is emptying SouthCoast classrooms: By Grant Welker The swine flu — or even the fear of catching it — .. 	flu
CONNECT NOW QUESTION OF THE DAY:  Are you worried about your pet contracting the swine flu after a cat in Iowa tested positive for H1N1?	flu
i definitely didn't know there was a swine flu outbreak on my sister's campus...ppl are being quarantined & everything. i'm worried...	flu
Swine flu is emptying SouthCoast classrooms: 						The swine flu &#8212; or even the fear of catching it &#82.. 	flu
If this swine flu putters out like the bird flu did ..I'm really gonna be mad	not_flu
#caringcurrents #H1N1 Swine Flu Alert: Adults Ages 50 and Older Getting Sicker, Dying In Higher Numbers  	flu
Want to know more about pets getting the flu? 	not_flu
getting hit with the flu... definitely picked something up at the hospital the other day :(	flu
Got my FluMist vaccine 2day! It's a great feeling, knowing that my friends+family WON'T b getting the flu from ME!	not_flu
I'm not afraid of swine flu! 	not_flu
@jcase_WBZ You sure you're not thinking of Jim Carrey in Forton Fears a Flu?	not_flu
Least its def not swine flu... But i think internal infection is riskier :/ im acc terrified i HATE being sick i NEVER get sick :(	flu
Researchers aim to stretch limited supply of flu vaccine. SAN JOSE, Calif. -- Worried there won't be enough of the  	not_flu
Finally got back from getting my swine flu vaccine. So much work to do ugh. All I want to do is go to sleep.	flu
My neighbors are making *so* much noise! I just wanna scream "swine flu" so they're afraid of me and leave my side of the building alone!	not_flu
H1N1 Flu Clinic Confusion: Fears and frustrations over H1N1.&nbsp; Why are some people getting vaccinated, whil.. 	not_flu
RT @jazgar Wall Street Banks Getting Swine Flu Vaccine Before Many High-Risk Groups (VIDEO) 	not_flu
nooo parking left; everyone's getting their swine flu shots across the street. i hope no more power goes out than what already has.	not_flu
Priority list for getting new flu shot still not clear: The ministry said earlier health wo.. 	not_flu
RT @ABeautifulLife: are you getting the #H1N1 shot? you're more likely to drown on your tub than to die from the flu 	not_flu
@BradIV Honestly, I was thinking the same about the swine flu w/ 1st msg. Was saying..."now, don't jump to conclusions, @jessica20one!". LOL	flu
More and more people I know are getting the H1N1 flu, or finding out that they had it. To all of you I hope you feel better soon!!	flu
Large NYC employers getting swine flu vaccine 	flu
@kjbrazil damn, another bailout.  maybe if they all got swine flu and died we wouldn't have to worry about constantly saving them	flu
Large NYC employers getting swine flu vaccine - The Associated Press 	flu
Large NYC employers getting swine flu vaccine 	not_flu
According to Channel 6 in Orlando, 61% of parents will NOT let their kids get the swine flu vaccine.  The word is getting out there.  YES!	not_flu
Large NYC employers getting swine flu vaccine - The Associated Press 	not_flu
RT @KathrinH77: RT  @DonnieWahlberg Now a sensitive issue: what are you thinking about the swine flu immunization? are you immunized?	not_flu
#health Large NYC employers getting swine flu vaccine - The Associated Press: 1010 Win..  #diet #weightloss	not_flu
@NetworkingGenie Twitter need to Get over that Bird Flu	not_flu
@NetworkingGenie twitter need to get over that bird flu	not_flu
Large NYC employers getting swine flu vaccine 	not_flu
RT @FizzyDuck: On hearing about the threat of Bird ‘Flu, Mr Bush had to be prevented from bombing the Canary Islands #FizzyArchive.	not_flu
@heathhaynes great!....now @heflipa is going to get the bird flu.	flu
@SamBradleyTN maybe its kind of like getting a flu shot in a way your body has to get used to the shots so you might.just might feel crummy	not_flu
Large NYC employers getting swine flu vaccine  (AP) 	not_flu
RT @kyockey: This is just plain wrong RT @huffingtonpost Wall St getting Swine flu vaccine BEFORE some high-risk groups 	not_flu
Arm REALLY hurts after getting the flu shot.	not_flu
	not_flu
RT @huffingtonpost Swine Flu Vaccine: Banks Getting H1N1 Doses Before Many High-Risk Groups (VIDEO) http://bit... 	not_flu
Wall Street Banks Getting Swine Flu Vaccine Before Many High-Risk Groups (VIDEO): While thousands of at-risk.. 	not_flu
RT @huffingtonpost Swine Flu Vaccine: Banks Getting H1N1 Doses Before Many High-Risk Groups (VIDEO) 	not_flu
#Worried #travelers see theme parks as petri dishes for flu 	not_flu
Crap I got a few minutes late to the doctors and I'm in the back of the line.WTF!!!! I'm also getting the swine flu shot, not fun.	not_flu
GOOD MORNING TWITTER... UP AND WORRIED ABOUT MY BROTHER AND NEPHEW THEY HAVE THE SWINE FLU ... PRAY FOR THEM PLEASE	flu
was getting over flu-like symptoms--just in time to see the Yankees win.  Now I feel sick again.	flu
Ouch RT @olore: RT @mattganis: went to cafe for coffee - ended up getting a flu shot! // #youwantaflushotwiththat	flu
Yep, time used the "I can has" reference to a cat getting the swine flu. 	flu
breakingflunews.com Hot Links: Why is Dallas County getting so much more swine flu vaccine p.. 	not_flu
RT @Tims2cents: World Health Organization says in two years, 1/3 of the world's population will have swine flu. Be afraid. Be very afraid!	not_flu
My roommate is getting a flu shot. This could get messy! Hes not too fond of them.	not_flu
Tan for health! Neat info on not taking flu shots but rather getting Vitamin D by sun, tanning, or pills. 	not_flu
RT @TIME: I can haz swine flu? A cat comes down with H1N1 | 	not_flu
At home w DS who isnt feeling well. I'd be more worried if we had not gotten the flu vaccine last week. Maybe it'll be a short lived bug.	flu
i'm getting flu and lil bit fever.. GOD gv me a power to survive.	flu
ABC News just announced that it's possible for your ferret to get the flu -a concern for ferret owners worldwide:)	not_flu
@sandrasampayo South African travellers fear lost luggage more than swine flu! http://miplanet.wordpress.com	not_flu
Here's my question. Swine flu vaccine - you getting it, or think it's dangerous? Seems like there's a lot of info circulating on both sides.	not_flu
Three Greensboro hospital workers resign after not getting mandatory flu shot 	not_flu
@carolandtom Thanks, stomach still protests when I try to eat, but getting the flu probably isn't a recommended weight loss strategy.	flu
@DogDayAftern00n because the bird flu was off within a year!though $bcrx not moving on this news	not_flu
Three Moses Cone Employees Resign Instead Of Getting Flu Shot 	not_flu
Class warfare being waged against Wall Street. Firms accused today of getting 100's of doses of scarce flu vaccine for their "fat cats".	not_flu
Getting a flu shot in a couple hours. Scared as fuuuuck! Hate needles..	not_flu
@TaliGillette we are getting regular flu shots. Emily's school is like a giant petri dish.	flu
@MishaRN flu shots - been concerned about getting both - a week apart...does that sound good? compromised lymph system.	not_flu
@TheDarkKing as a biologist I'm not scared: it's just media frenzy. That flu is not even that infectious, there have been way worst before.	flu
Off To Bed, I'm Tired And Feel Like I'm Getting The Flu!!! I Hope Not Cause I Hate Feeling Sick...	flu
Schools brace for substitute shortage: With flu spreading, some school officials worry that they could end .. 	flu
THE GOVERNMENT ADMINISTERED AIDS, BIRD FLU, SWINE FLU..C'MON NOW GET HIP! ASK QUESTIONS	not_flu
Well, Well, Well: Flu Vaccine: ... and for those concerned about virus or thimerosal exposure, it can be booste.. 	not_flu
REGION: Two more people die from swine flu : Two more people have died after getting sick with swine flu,count.. 	not_flu
Who is getting their flu shot for the first time! Just did it, man am I dizzy	not_flu
@ceciloop here the H. Minister says that it's less aggresive than regular flu & we don't have to be worried O_o Mmh, I'm a bit puzzled!	not_flu
One third don't trust swine flu vax 	not_flu
@BeantownCutie are you ailing as well? i asked @jordanstrouble if she had the oink oink she said "we're calling it BIRD flu" tweet tweet!	not_flu
@marieosmond Glad to hear you are getting better from the flu! Mary Hart mentioned it on ET!!	flu
LOL! WORD! RT @NIKEorqasm Mad cow (no beef), Bird flu (no chicken) and now Swine flu (no pork).guess the only thing safe to eat is PUSSY!!!!	not_flu
@JennaRJacobson meee toooo. everyone around me is getting the flu or h1n1. i need to be healthy	flu
Bird kill, bag ban, flu death, tax break and other news - 	not_flu
My arm is sooo soar after the Swine flu shot!!! It hurts... but I'm getting used to pain because I'm in a lot of pain a lot... soo......	not_flu
RT @basseyworld: Who wants to take me out on a date next weekend? Not you, I have swine flu. *cough* But you... I'm thinking @eatonville.	flu
@SherriEShepherd my daughter has chronic lung disease, can't wait to get her the shot, am more worried that she gets swine flu, higher risk	flu
@the_magpie ::smack:: shut up and snap out of it your not getting swine  flu and not gonna die from something you dont have	not_flu
Me no feel good. :( Wonder if I'm getting the piggy flu....	flu
@ZenMonkey Really? Mine only swear at other cats from a distance. Doubt I need to worry. Having my flu jabs on Saturday, may include swine.	not_flu
School, health officials grapple with swine flu: by Kelsey Mesher Flu season is getting underway in earnest in .. 	not_flu
Official fired over Calgary Flames getting flu vaccine 	not_flu
School, health officials grapple with swine flu: by Kelsey Mesher Flu season is getting underway in earnest in .. 	not_flu
i have the flu... i hope it's swine.. if i live im so getting a shirt that says "i survuved the swine."	flu
is all of a sudden worried about catching the swine flu at the very wrong time this month :O(	flu
Angola: Veterinarians at regional seminar on bird flu - 	not_flu
Colaiacovo getting over the flu 	flu
FLASHBACK: Homeless people die after bird flu vaccine trial in Poland 	not_flu
BIRD FLU NEWS Seasonal flu clinics in Montgomery Co. schools end (source: wtop.. 	not_flu
I'm so freakin' afraid of the Mexican Flu; I hate a running nose.	flu
is more than scared that stupid flu, I just hate it so much, there´s no words to describe my feelings! Hope my little sys is getting better	flu
another night class tonight= my teacher getting another email saying I have the flu	flu
west nile virus &lt; bird flu &lt; swine flu &lt; swag flu	not_flu
Lubavitch.com: Ukraine Closes Schools Nationwide For Fear of Swine Flu 	not_flu
This month's poll: Will you be getting the H1N1 Flu Shot? 	not_flu
breakingflunews.com Ukraine Closes Schools Nationwide For Fear of Swine Flu - Lubavitch.com:.. 	not_flu
#swineflu Ukraine Closes Schools Nationwide For Fear of Swine Flu - Lubavitch.com: China DailyUkraine .. 	not_flu
Awake I guess..lol Getting my flu shot today. That's exciting.. Heading to NYC this weekend I cant wait its been a while.	not_flu
Feel like I'm getting the fucking flu! This better be a joke	flu
Flu Experts Gear up for Pandemic of Vaccine Worry: One million heart attacks, 700,000 strok..  	not_flu
@secondglantz thanks. my first flu since getting diabetes and it's trickier than i thought.	flu
Are you getting the flu shot? Dr. O'Malley isn't. Read why in his latest blog post: 	not_flu
@Kenobi2009 nope just weird Japanese people terrified of swine flu! 	flu
Nandos outta poultry AGAiN?! Is bird flu back or sumin?	not_flu
News Flu H1N1: Neurosurgery department does not function, doctors fear assault (HT via Yahoo! India News) 	not_flu
RT @AfricaTourGeek Travellers fear losing luggage than swine flu – Travelstart 	not_flu
@djmotwister I think that this decade will be known for all the epidemics. Bird flu, mad cow disease, meningococcemia, SARS and A(H1N1)	not_flu
Travellers fear losing luggage than swine flu – Travelstart 	not_flu
oi how many of you people are getting the swine flu vaccine? 	not_flu
RT @mrozeluk: Swine flu, bird flu, mad cows. Animals just can't be trusted anymore.	not_flu
Some people here are afraid to get vaccinated against Swine Flu because they think its coming from pigs.	not_flu
Maybe getting H1N1 could help in the LR by building resistance to the next bad flu that comes along. Judgment of Good or Bad = Is that so?	not_flu
@kateleroux  Agree about the fear-mongering in the "news". But H1N1 spreads quicker than the usual. I hope it doesn't mutate with avian flu.	not_flu
Prison inmates getting the "Swine Flu" Vaccine? Things that make you say hmmm...	not_flu
I'm not getting the swine flu shot, just to spite the media and the millions of terrified idiots waiting in line for hours.	not_flu
Swine flu and the downside of positive thinking 	not_flu
Do I take the flu shot or not? I'm scared.	not_flu
hi :) ...flu shot clinics like war of the worlds or noah's ark... thinking if something is only half finished then its not done...	not_flu
everybody seems to be getting sick. and its not just the flu, but other random things. it sucks. hope everyone feels better soon!	flu
@AmandaVega recovering from what I assume must have been the bird flu. love the new pic. you look totally diff. what's new?	flu
Ok getting the swine flu shot... wish me luck.. don't wanna turn into a pig.. :\	not_flu
Getting over the mini-flu after my H1N1 shot.  My son also seems to be doing better now.  He'll hopefully sleep tonight!	flu
@1momof5 Yeah, I had my flu vaccine, so I'm probably good on that front... but wondering if I'm getting a cold...	not_flu
The school I'm working for has a pretty nasty outbreak of the flu. I'm kind of glad I've already had it, but still nervous.	flu
That means 78,3% of people who rush to the ER thinking they have the flu, DO NOT and have only a cold...so STAY home!!!But.... even more	flu
is feeling ruff today getting over the dreded flu :&lt;	flu
RT @Moronail People worried about swine flu. 	flu
I think I'm getting the swine flu.  Awesome.	flu
Case of H5N1 (Bird Flu) and H1N1 (Swine Flu) Co-infection Found in Egypt- 	not_flu
#filmdisease One Bird Flu Over The Cuckoos Nest	not_flu
RT @ujjaldosanjh those who decry legitimate criticism of Cons unpreparedness re Swine flu: Stp belittling real concern. #lpc #roft #cdnpoli	not_flu
LOL!!! RT @Bekemeyer Dear bird that shat on my freshly washed car: I hope you catch the Human Flu and die. :P	not_flu
hope their swine flu are not getting worse, get well soon YamaP, Ryo	flu
years ago, Chinese calendar year of the bird . . . Avian flu. . This year, Chinese calendar year of the pig . . . Swine flu. Next year is	not_flu
Suddenly famished but scared to go get lunch due to peer pressure from h1n1 flu shot staff. How many times do I gotta say no?!?	not_flu
have never seen so many people wearing surgical masks outside before. mass media succeeded in spreading swine flu fear and increasing sales	flu
@ work getting ready 4 the flu clinic rush lol	not_flu
RT @KellySpors: Lack of Paid Sick Days May Worsen Flu Pandemic(via NYT) 	not_flu
I'm scared 2gt a flu shot.	not_flu
@VixenSoleya im scared 2 get the flu shot i dnt wanna b wlkin backwards like that white bitch on the news	not_flu
RT @hotboxbeats   h1n1 is the new y2k - hhhmmm, I say it's more like Anthrax into Bird Flu into H 1 N 1 - 2012 is the new y2k for suckers	not_flu
Today looks like another raining day. Not feel good and getting flu now. Hope it is not H1N1.	flu
New post: Some inmates getting the swine flu vaccine before Hampton Roads families - WTKR Your NewsChannel 3 (	not_flu
High school teacher dies after getting swine flu 	not_flu
A helpful resource about a topic many of us are concerned about...Swine Flu. 	not_flu
nothing at all thinking about you alot :) a real bad flu going arounf here everyone is sick	flu
@typeoff BTW, I am almost getting sick now. Maybe it was from the move :P Or we could have swine flu?	flu
Sick listening to my boss preach to me about getting the swine flu injection i dont want to get it ive no health problems!	not_flu
Who wants to bet I'm coming down with H1N1? Supposedly an outbreak in la. And I'm getting 'flu like symtoms' lol.	flu
Swine Flu is running rampant in Salina now, and I think I'm just now getting it. Just in time for the move! Nice going away present KANSAS!	flu
@angryaussie Annual deaths from regular flu are between 250,000-500,000. How many died of swine flu? Bullshit fear. 	flu
Now I have bronchitis and a 101 fever that may indicate I'm also getting the flu. Lovely...but this too shall pass.	flu
I hate being siick. Going to get swine 0.5% sure and 10% sure im getting the flu :l	flu
Army Issues Hand Gel, Cough Orders In Flu Fight: Soldiers in boot camp are getting something new this year besi.. 	not_flu
This #theworst time to be possibly getting the flu!	flu
Gold medal skater Kristi Yamaguchi joined us to talk about getting your kids immunized with the flu vaccination 	not_flu
I'm really hoping I'm not getting whatever flu my brother had this past weekend. I cannot get sick!	flu
First we had made cow disease, then we had bird flu, now we have swine flu, O.M.F.G it's FARMAGGEDON !!!!	flu
Ukraine in be scared over swine flu 	not_flu
@stephenfry ur avatar is a bird and your background has defaulted. You must have avian twitter flu	not_flu
my coworker has swine flu. this is getting too real.	flu
This is totally epic. We are getting our flu shots. My mom is filling out sydneys form. Ha!	flu
So cold! I have 5 blankets on and sweats complete with socks and i cannot get warm! Think im getting the flu.	flu
Yikes! never considered this. If this swine flu fiasco is a foreshadowing of how government will handle healthcare, I fear we're in trouble.	flu
RT @daveshackleford: Wow. For those of you SCARED about #H1N1: Get a life. It's the damn FLU. Why are we so worried? Pathetic.	flu
@mvarroyo got the flu shot over a month ago. I get sinus infections b/c of allergies. Dr. didn't care to listen 2 me. Getting a 2nd opinion	flu
New York News: Swine Flu News: H1N1 Vaccination Program Continues Amidst Fear of Vaccine  Please RT	flu
I'm a little but scared of the swine flu, because it seems like everyone around gets ill... Me either	flu
@mommiedaze I'm glad he's ok! I have been very worried about the flu, even though most say not to. I hope he gets some rest & feels better.	flu
RT @HomelandSecNews: Homeland1: Swine flu shortage leaves doctors to manage anxious patients 	not_flu
@briscam5 Hi Brian, I was thinking about you earlier! Just getting over a bout of flu, will make a new vid later! Hope you are keeping well!	flu
Presents "FLU WEEK!" Learn the odds of getting the flu, dying from it, & the odds you'll dodge the shot because you're afraid of needles...	flu
Do you plan on getting the swine flu shot?	not_flu
Rewarding myself for getting a flu shot with a pumpkin muffin from my favorite bakery.	not_flu
RT @Reneepaints What's the difference between Bird Flu & Swine Flu? For bird flu you need tweetment and for swine flu you need oinkment.	not_flu
No point in getting stabbed with the weak pig flu now! My housemates have already had it so I've almost certainly been exposed.	not_flu
RT @channeldvorak: Public school kids are getting swine flu vaccines without parents’ OK 	not_flu
Im getting the bacon-flu shot later today!	not_flu
Vietnam reports bird flu outbreak among poultry 	not_flu
I am terrified to get the flu shot	not_flu
RT @anamus_c: Vietnam has announced the reemergence of bird flu among its poultry 	not_flu
Order Monavie Where to Get a Flu Shot Is Big Worry of Season: From telephone hotlines to vaccine d.. 	not_flu
Someone really has to get swine flu at my school, asap because I'm starting to get scared they will not shut them down!	not_flu
Brother-in-law says he's not getting flu vaccine and then immediately turns around and judges me because I said Peanut and I may not. WTF?	not_flu
@shwood don't take it personal. My mom and little brother are just now getting over the flu, I still have a cold, and wife is soon to follow	flu
How to prevent getting swine flu and what to do if you have it 	not_flu
So my brother just chased me around the house with vitamin D and C to "protect" me from swine flu. This is getting a little out of hand	not_flu
Op-Ed Contributor: Nothing to Fear but the Flu Itself: Why Americans are wrong to fear the H1N1 flu vaccine. 	flu
@diorabaird1 I'm getting my checkup tomorrow. 12 hours of no food, then bloodwork galore. If I have h1n1, we can be flu buddies. :)	flu
RT @JackFacts24 Jack Bauer was able to eliminate Bird Flu playing Duck Hunt. #24	not_flu
San Antonio: Millions Without Sick Leave Fear Swine Flu 	flu
Okay, so I failed to catch swine-flu in the US, but I'm suddenly getting some-sort-of-flu back home? *plays the lessee-where-this-goes card*	flu
Millions without sick leave fear swine flu: CHICAGO – For millions of Americans the rule is simple: If you don'.. 	not_flu
How to prevent getting swine flu, how you know if you have it and what to do if you do get it 	not_flu
Go figure. GOD says pork makes us unclean=swine flu. wld yr chances of getting swine flu go dn if U dnt have pork swimming through yr veins?	flu
god who hasn't gotten the flu? i am sick as i type this =/ . hope it goes away before school so i don't have to worry about catching up.	flu
What's the difference between swine flu and bird flu? With swine flu, you get oinkment. With with bird flu, you get tweetment!	not_flu
Why isn't BHO getting reamd about the shortage of H1N1 flu vaccine like Bush was a few years ago for a similar shortage? Double standard...?	not_flu
Millions without sick leave fear swine flu  (AP): AP - For millions of Americans the rule is simple: If you d.. 	not_flu
Thought I had made up my mind on NOT getting kids flu shots, but my stepdad is a peadiatrician and told me I'm nuts not to.What to do?	not_flu
Forget Swine Flu! It's Zoo Flu you need to fear! The animals are ready to attack! http://camerawinks.wordpress.com	not_flu
@ramoore11 I watch you TRY to catch the swine flu! You did fail, but I wouldn't chalk that one up to you doing well not getting sick.	not_flu
Millions without sick leave fear swine flu: The Associated Press That idea drives an untold numbers of carpente.. 	not_flu
Millions without sick leave fear swine flu: Millions without sick leave fear swine flu: CHICAGO (AP) — For mill.. 	not_flu
Millions without sick leave fear swine flu - The Associated Press 	not_flu
Millions without sick leave fear swine flu: The Associated Press&quot;If I&#39;m well enough to sit up in bed .. 	not_flu
@envyme Oh, is this the normal flu, or swine? I heard getting the shot anyway, is bad?	not_flu
If you are worried at all about swine flu then take a peek here: Click Me for Health Now 	flu
A Q&A on how to prevent getting swine flu and what to do if you have it 	flu
Yesterday it was 80F and today it will be mid-50s. Forget swine flu, mother nature has a hand in getting everyone sick.	not_flu
instead of saying "trick or treat" the kids this year should have said "Swine Flu!"  now that would have scared people!	not_flu
New post: How to prevent getting swine flu and what to do if you have it - Washington Post (	not_flu
PIG AIDS! #swineflu Some are more worried about vaccine than about the flu - The Morning Sun.. 	not_flu
breakingflunews.com Some are more worried about vaccine than about the flu - The Morning Sun.. 	not_flu
#swineflu Some are more worried about vaccine than about the flu - The Morning Sun: MiamiHerald.comSom.. 	not_flu
Shit, I'mma a little bit scared of H1N1... ('cause I gotta fly back home on Friday) Whatchu think of this flu?	not_flu
Canadians pack clinics in hopes of getting flu shot #Canadians  	not_flu
RT @SwineFluLatest: How to prevent getting swine flu and what to do if you have it - Washington Post 	not_flu
How to prevent getting swine flu and what to do if you have it - Washington Post 	not_flu
@gruber Would that be bird flu?	flu
Tips: How to travel safely in flu season: ... worried about exposure to illness, even if a pandemic is declared.. 	not_flu
How to prevent getting swine flu and what to do if you have it - Washington Post 	not_flu
RT @digitaljournal Swine flu fear grips Ukraine as death toll dramatically rises 	not_flu
I'm getting sick...I can feel it....Mom's gonna be mad. Apparently she thinks its all in my head, I'm sorry I can't fake the flu.	flu
Canadians pack clinics in hopes of getting flu shot 	not_flu
Flu Watch: Do we now need to be concerned with the strain 	not_flu
	flu
Canadians pack clinics in hopes of getting flu shot - The Globe and Mail: 	not_flu
Getting my ninja on. My mask makes me look like a terrorist fighting off swine flu.	not_flu
Happy Halloween everyone..  I'm stuck at home with the flu but dont worry its not swine flu =p	flu
Awaiting arrival of neighborhood candy-grabbing SWAT team. First kid dressed as Swine Flu gets triple candy. Fear the Hamthrax!	not_flu
@djcnorwich Again, insurance is the problem. Insurance is for catastrophe. Getting the flu is not catastrophe and not super expensive.	not_flu
Getting my flu shot	not_flu
These wait lines for the swine flu shot are getting insane..	not_flu
@babystephannny Thankfully my mom hasn't pressured me into getting it. I don't even remember when was the last time I had the flu shot.	not_flu
Swine Flu - How worried are you? - Take our poll now and check out how others feel! 	not_flu
@wcrd @OverThePylon - new name for the wildcat is bird flu - really??? #GoBallState	not_flu
not getting swine flu vaccine: 	not_flu
@Ddub_a_licious I felt like sh*t for two wks after my flu shot theirs NO WAY I'm getting the swine flu shot not enough studies done on it.	flu
U.S. Airports to screen for swine flu. Take a questionnaire and try not to cough or you're not getting on the plane. 	not_flu
Swine flu getting a foothold in state - The Boston Globe "swine flu has the state in its crosshairs once again " 	not_flu
@BevJack worried why? it's like a reg flu shot. i'd be more worried about getting H1N1	flu
@eczemasupport the link in the tweet about the boy with eczema not getting a flu shot is the link about uninsured children...	not_flu
RT @lizarddawg: Shhhh CBS just came out and said that swine flu cases were overestimated – all that fear #tcot #gop #politics #iamthemob	not_flu
Raking Leaves these days.  Getting over the flu too.	flu
@Uncucumbered :) I'll try, but I'm afraid dentists to me are like flu shots for you. Eek. Getting my Halloween scare early in the day.	not_flu
What? I have to get the Swine Flu vaccine? But you told me we were getting Starbucks!	flu
@ffjewelry Oh I hope I am not getting the flu too! Mom has no time for the flu! LOL DD had it last week until Wednesday!	flu
The flu shot is handicapping people now??? What happen to just getting the flu? Ugh!!! Someone needs to pay for what they did...	not_flu
RT @ajira_k: the guy giving me a flu shot is in a flintstones costume...should i be worried &lt;--Be afraid, be VERY afraid	not_flu
the guy giving me a flu shot is in a flintstones costume...should i be worried	not_flu
Min-by-min reporting on Arsenal 3-1 Spurs (12.45) and Man Utd 2-2 Swine Flu XI (5.30). Then getting my zombie on and shuffling to a party.	not_flu
NOOOOOO! RT @rossching Swine flu is really getting out of hand: 	not_flu
Have you found this? on why I&#39;m not getting the swine flu vaccine.:.. 	not_flu
The weather is getting cold and i'm worrying about getting flu....	flu
Do not fear - Turmeric is here!  Dear Tweeps- just a bit of preparation can give U the power to laugh at the Flu Season - germs will cry.	not_flu
RT @pwarnock: RT @eclairebears What's the diff...Bird Flu & Swine Flu? For bird flu you need tweetment & for swine flu you need oinkment #fb	not_flu
&quot;3% of blacks are getting swine flu.&quot; Adam Curry: 3% of blacks are getting the swine flu ac.. 	not_flu
Kelly trying out lipgloss "oooops, up mah nose. someones getting swine flu" LOL #fb	not_flu
This is a lousy weekend to be getting sleepy at 8pm. Flu and I need to talk.	flu
R @charitylawyer What's the difference between the bird flu and the swine flu? One gets a tweetment. The other gets an oinkment!//got it :)	not_flu
Photo: Swine Flu vs. Bird Flu vs. Zombie Flu!!! via DeadDog. 	not_flu
This cold I have had for the last 4 days is not getting any worse, but it's not getting any better. Turned down for a flu shot cause of it.	flu
RT @JayKasai: People r stupid getting a flu shot wont save you from the swine flu!	flu
LOL! RT @DwsTrashyWhore 1st we had Mad Cow disease.. Then we had the Bird flu..now we have the swine flu.. OMG ITS FARMAGEDON!	flu
@SanDiegoCounty is getting flu shot shipments, and giving tax refunds 	not_flu
So 8 people in Utah have died from Swine Flu? 8 out of 2.7 million. My odds are 8 in 2,700,000 that i'll die from it? Not concerned still.	flu
Swine flu cheaters getting vaccinated  #24hourz	not_flu
People outside priority groups getting swine flu vaccine: It was bound to happen: Some people who aren't at hig.. 	not_flu
Worried that you might have the H1N1 Swine flu? Visit the H1N1 Response Center and take the online assessment 	not_flu
I already had enough sleep todayy.. My flu is still the samee.. Yet my massive headache is getting worstt.. )=	flu
Fluheadlines Swine flu fear grips Saudi govt on the eve of Hajj: NEW YORK, Oct 30: This should be v.. 	not_flu
[feed] New Halloween concern: Swine flu 	not_flu
@RoseyMainvein on plus side I won't get ill from yukky students spreading germs but on minus side, worried about stories from last flu shot	not_flu
@claire_90 injections don't bother me... I am so used to them. I will be getting a flu shot as soon as my clinic has it.	flu
Genuinely worried that I might have swine flu :( seeing the doctor in awhile, we'll find out soon.	flu
Health.Dating-Viagra Swine flu cheaters getting vaccinated 	not_flu
;o! dont wanna go to the doctor...im scared! i might hav flu!	flu
Smile More: This whole swine flu thing is getting outta control: The Winne Da&#8217; Pooh crowd is .. 	not_flu
Swine flu cheaters getting vaccinated: It was bound to happen: Some people who aren't at high risk for swine fl.. 	not_flu
@darrmurr:  "Schweinegrippe"  Germans are worrying less about swine flu? Seems like it. // We worry more about flu shot with adjuvants.	flu
RT @WTMJohn If TV has video of Brett Favre getting the Swine Flu Mist Vaccine, would it be running on a 24-hour loop? Just asking	not_flu
Boss no in today-son has swine flu. Piano tuner not coming today-has swine flu. This is getting way too close!	flu
getting swine flu vaccinations...agree or disagree?	not_flu
What is the difference between Bird Flu and Swine Flu?For bird flu you need tweetment and for swine flu you need oinkment	not_flu
Cheek by Jowl in Hong Kong, some bugger has given me a cold - lets hope its not piggy flu! getting on plane should be interesting!	flu
Why does the flu bug hit when exciting plans are planned? I feel like death... Thanks for getting me sick @johnnys65!	flu
I am interested in what people are thinking about the H1N1 flu and the shot....I got the shot today, wasn't going to but did.	not_flu
Only a 2.5 hour wait to get the flu shot. More than twice that long to upgrade my Desktop to Ubuntu 9.10. Their servers are getting slammed.	not_flu
first we had MAD COW disease, then we had BIRD FLU, now we have SWINE FLU... holy crap, its FARMAGEDDON!!!	not_flu
2 years ago Chinese calendar the Year of the Bird-we got avian flu.	not_flu
Getting a flu shot. If I start talking about how great Pelosicare is, then you know they've really given me a government mind control drug.	not_flu
RT @mercola AVOID GETTING THE FLU by NOT smoking. It dries out nasal passages and paralyzes cilia, the small hairs. 	not_flu
RT @pourmecoffee If Chuck Grassley were in charge of H1N1, we'd be getting corn-based "High Fructose Flu Syrup" instead of vaccines.	flu
@justinbieber Please take care of yourself out there Justin. The H1N1 flu is all over and we dont want you getting it. I Love u &lt;3	flu
ugh. flu season. some of us don't have the option of getting sick. we gotta keep pushing - rain, snow, or shine.	not_flu
Well... I don't have the flu... YAY ME! lol... it's either Strep or just some random virus that's pissed H1N1 is getting all the attention.	not_flu
Is it just me or all these tips on how to prevent getting swine flu tips on how to prevent getting any air born disease?	not_flu
Agggh, I'm going to be waffling about getting a flu shot until the last minute. I always get sick from them! But...	not_flu
@stephaniewg Are you really getting the swim flu shot?	not_flu
2 die in Athens wreck after getting flu shots 	not_flu
Entertainment News Kevin Costner 'worried over swine flu': Kevin Costner is sa..  :: digital spy	not_flu
RT @ksummerall I'm not concerned about getting the swine flu because I use a Mac. (via @dewde)	not_flu
KAY SO IM AFRAID TO DIE COZ OF THE SWINE FLU COZ LIKE SOME CHICK BARFED IN THE MIDDLE OF FRENCH CLASS	flu
@AmandaLynn_xoxo If you're getting the flu shot, hope your not one of the      1/1 000 000 who get the side effect :P	flu
@BrokenStruggle lucky you, sadly I am still at work. My allergies are turning into a cold or flu I fear. A few pints could make happy	flu
Next time someone mentions swine flu, show them this chart: 	not_flu
RT:  @josecastillo A 22 yr old died from the swine flu after delaying treatment; uninsured and "worried about the cost." 	not_flu
Delay in getting the swine flu vaccine in Cyprus:  	not_flu
Afraid Of Swine Flu - Holiday Shop Online & Get Cashback & Discounts On All Your Purchases! 	not_flu
RT @peschkaj: RT @dustinson: Swine Flu paranoia getting out of hand!! 	not_flu
Would it be overkill to clean the walls with lysol disinfecting wipes? Some one stop me, this swine flu threat is getting to me.	not_flu
Not fear-mongering, just good common sense about swine flu: 	not_flu
gONNA GET MY FIRST FLU SHOT....Eeeeeek! Im scared!!! I have one last test for school....Im gonna get a 100% I can f ... 	not_flu
Getting a flu shot at Centacare	flu
People keeping kids home on halloween fearing swine flu spreading? Better keep them out of school then too, your fear-mongering a-holes.	flu
I was considering getting my son vaccinated but was told by his pediatrician that they're still waiting to get swine flu shots. Lame!	flu
"You got the common cold? We got the Bird Flu." - Gucci	flu
The Swine Flu is an orchestrated attempt to spread fear and chaos into the population and to try to get people vacc... 	not_flu
Not getting the H1N1 vaccine, I've decided. I've had far too many strains of flu over the years, so the virus can do its worst!	not_flu
Flu Prevention: Avian Bird Flu Information and Its Treatment | Vote Now! 	not_flu
India is Bird Flu Free	not_flu
Link: Khaleej Times Online - Egypt school start delayed week in swine flu fear 	not_flu
Well I'll remember this birthday for sure. Wife has Swine Flu that's not getting better so she's currently in the ER. HELLO 36!!!	flu
@mrfortworth pls do so!!! lol... i don't wanna die in my sleep jux cause i'm worried i'll die of swine flu!! i can see dat on da news.. lol	flu
@sillyyak11 Haaaa., I was afarid of getting the swine flu from him so I stayed away too. Haaaaa..	flu
As much as i tried 2 avoid getting the flu from my family members. My throat is starting to hurt :( anyone have remedies for a sore throat?	flu
I be getting sick.  Kids got me sick, ugh! Better not be swine flu!! =)	flu
Got the H1N1 Flu shot, 4 hours in the line (mostly outdoor) to get it. Was very cold, probably caught a cold b4 getting the flu shot :-)	not_flu
The media is making this flu much worse than I think it actually is. Fear only breeds more fear. Let's be rational and look at the stats...	flu
finally home. think I am finally getting the flu bug. Argh!	flu
Afraid Of Swine Flu - Holiday Shop Online & Get Cashback & Discounts On All Your Purchases! 	not_flu
are you swinging back and forth on getting the flu shot?... now I'm thinking of NOT getting it...	not_flu
@ellept Whoa, seen this? Dystonia from the #flu shot. I'd be weary about getting #vaccines in the US! #H1N1 #health 	not_flu
My girl's getting a flu shot. This place is a zoo	not_flu
I'm getting my seasonal shot this 	not_flu
@Hanna_I Im not getting that damn flu shot. It feels like Xmen movie or something. and yeah christian troy for sure!	not_flu
Getting a little fed up with having (Insert Random Animal) flu. Most depressing.	flu
Just getting over swine flu.  It must have been the roast pork I ate the other Sunday!	flu
Trying to decide whether or not to get the H1N1 flu vaccine today....Worried it might make me sick, worried I might get sick without it.	flu
It was a Robitussin Nighttime Cold & Flu kind of night. I think I may be getting a cold. Tell my nose breathing isn't optional. Poo...	flu
jesus christ all the 	flu
Getting better,no more piggy flu 4 me,It was nasty, dont wish it on anyone.Ppl wash ur hands and use the hand sanitizer,TRUST ME	flu
My daughter and I are getting our flu shots this morning.  Not the funnest 	flu
I have a cold and a fever and swine flu is getting a little too close to home for my liking.	flu
is getting a flu shot....finally!!!	flu
Recovering from possible flu - I'm so behind the times, it was probably Bird Flu.	flu
3 out of 3 of my staff members have come down with the flu. Will I be able to hold out? :nervous:	flu
@Indianadelae last time I felt like I was getting the flu, I felt bad for a day, then woke up fine the next.  Hoping that happens again!!!	flu
My throat has that horrible half sore feeling like when you're getting sick. NO FLU!!	flu
@chrispirillo bird flu I guess	flu
this flu is getting worst :(	flu
Afraid Of Swine Flu - Holiday Shop Online & Get Cashback & Discounts On All Your Purchases! 	flu
I am not getting a flu shot in fear of walking backwards. C'mon, my big head can't be off balance. sighs :-(	flu
Just b/c I'm not getting the H1N1 flu shot, doesn't mean i'll stop others - Here's the schedule for free shots in Sacmto: 	flu
Resting 2day ad my mthly blood test last 1 ok got apoint 4 flu jab being lky so far not getting swine flu thats something	flu
@henweb  Swine flu jab. Hmm! We are going through the same thing.Elder son HAS to have it next week - but I am worried	flu
Fuck this better not be pneumonia!! I'm just getting over the swine flu!! I hate you Brandon!	flu
@RyanStar OMG that's scary. I am definitely not getting a flu shot.	flu
sitting on the couch, watching "It's the Great Pumpkin Charlie Brown," afraid I have flu-like symptoms.	flu
At the hospital, got to get the flu shot.. Things are getting risky!	flu
@endlessprattle Is your workplace really quiet?The hospital was quiet but we're actually getting people with swine flu admitted.Getting bad.	flu
My arm is back to normal after getting the flu shot. For a lil bit, I thought I was going resident evil.	flu
Discovered the Newton Library today while getting flu shots for Sofie ... now back to the deck!	flu
@TheIncendiary Dude I'm getting sick too. It blows. And my friend who has the swine is only 12...that just ain't fair. Kids shouldnt get flu	flu
#funnybutnotcool sneezing in the middle of a store and everyone stays away from you thinking its swine flu.	flu
Joy is getting ready to finish scripting "Stage Two" while being sick with the flu.	flu
When FEAR (of swine flu) knocks at YR door, send FAITH (Jesus) to answer it and when the door opens... FEAR is gone. Psalm 91:10	flu
im getting over this stupid flu and doing hw ok where do u use equations in life and intergers and crap like i dont understand it	flu
@debmarkham hope you're not getting the flu, swine or otherwise. Are you gonna skip hunt club then?	flu
What's good tweople. Getting some grub then getting this flu and H1N1 nonsense taken care of	flu
is getting sprung today :) flu neg, but has to start antibx. feeling better & can't wait to get home. thank you Lord!	flu
Drinking my apple cinnamon thera-flu getting ready to be knocked out. Trying to stay on top of this bug before it grows.	flu
@The_Megster @BackpackingDad You're welcome. My family did our civic duty, contributing to herd immunity by getting the H1N1 flu vaccine.	flu
My concern regarding whether or not I have swine flu is strictly financial. I shouldn't qualify to contract this sickness.	flu
My lil has swine flu I'm scared for myself now omg	flu
Getting over the flu :-)	flu
@TraceyMmm I think I'll be okay, I'm just getting over this flu bug & it's trying to kill me.  But, I'm winning!	flu
I'm not really concerned about swine flu. However here's my concern: 5 yrs ago Chinese calendar year of the... 	flu
trying to hunt down local flu-shot clinic - wow, it's just not out there yet, is it? makes me nervous, cuz I've gotten flu in early-Nov b4.	flu
At the Dr now- having kids examined again. Can't get flu relief. Poor babies. I'm thinking I need a flu shot now even though I feel fine.	flu
Elderly Israeli dies three days after getting swine flu vaccine 	flu
@jencaseysmith Shut up! Seriously? Hope you're not getting swine flu! Maybe we should go to the hospital then!	flu
Just came from getting  swine flu vaccine..not crowded.. If  in  group that qualify, CHEC  till 4 PM today.. 	flu
piggy flu scared.	flu
@lisa24270 but to counter that is the worry that she gets the flu and is seriously affected because she's not had the jab!!! coin toss time!	flu
Are you worried about swine flu? For info call 0800 1 513 513 or visit 	flu
health progressively getting worse. hope i don't have the Mexican Flu!	flu
feels like he is getting the flu.   :(	flu
I'm getting mighty frustrated with ppl who have no clue about viruses or vaccines spreading misinformation about the H1N1 flu shot!	flu
@QueenbeeTF Not the leg. I'm thinking flu. And i have to do a presentation for the project I'm working on to our VP and director...	flu
	flu
Wat wit all this swine flu worry does anyone remember when all we had to worry bout was bird flu? Ah the olden days!	flu
Moving the last of the junk to the new place. Worried about swine flu gestation @ work.  Tired. Hongry.	flu
Swine Flu - How worried are you? - Take our poll now and check out how others feel! 	flu
Friday: 8:30AM: Donating blood. 10:30AM: Getting the swine flu shot. Have I mentioned that I'm terrified of needles?	flu
i have the swine flu. have had it since thursday. you don't want it. it feels, as i imagine, like death. but i'm getting better now! :-)	flu
Setting foot outside for the first time since getting the flu.	flu
@tandcmitchell @danalajeunesse  same with the chickenpox vaccine and flu. So I am leary about getting her this one. I hate not having	flu
Guess I'm getting my flu shot on Wednesday. It is going to make me so blah all day and probably most of Thursday.	flu
hubby's home 	flu
is almost flu free today.   Feeling much better and am looking forward to getting back to work.  Never slept so much in 3 days.	flu
Morning??? Already? It's gonna be a long week capped off by the fam flying to Oklahoma. Will we make it swine flu free? I'm nervous.	flu
It occurs to me that getting a super bad flu bug was some sort of cosmic joke on me for being "Swine Flu" on Halloween.	flu
@harrymarkov - spellings fine and from the way I feel, it could be any one of them but I'm thinking a mild flu.  Yipee.	flu
Haha! I'd be nervous. RT @bestieverdid: @KOttavio Isn't he afraid of catching the flu from all those kids? Or is Santa magically immune?	flu
6:30 am with notification of daycare closure. The flu bug is getting closer. Happy Monday. I'd rather be listening to the Happy Mondays.	flu
Am I the only person that is not scared of this swine flu shit?	flu
People are getting flu. And so am I. I'm feeling it right now.. Hope I can survive the flu while keep working *if I really got hit by d flu*	flu
Thinking my day job & home are the same. Waking 1 kid every 2 hrs 2 chk concussion & managing swine flu in other. Catching up on Ellen Show!	flu
So one of my co workers just told me her daughter has swine flu... uhh should I be worried?? Someone bring me lysol and quickly!!! Ahhhh!!!	flu
Still getting over the flu!!!	flu
Getting my flu shot, great	flu
Swine Flu And Bird Flu, What Are The Precautions To Take And Which ...: By Dog Lover | October 25, 2009. We are.. 	flu
@Mernahuana Ohh, still no idea what it is lol. But if it's comparable to swine flu, it's definitely not what I'm getting over!!	flu
@NinoMizrahi lol i havent got a vaccine for that should i be worried lol..i dnt even get da flu like dat though...	flu
@neoyiling we had sex on the beach in full view of others :P what's the software called? anyway how's your flu? getting better?	flu
Worried about catching the flu, lots of hand sanitizer in use.....lol	flu
@MoniqueMilian good just getting over the flu but i woke up feeling much better this morning still not 100% anything new with u dat exciting	flu
why isit just because of rain, i'm getting my flu back? gosh~~~	flu
Swine flu? Why dont people worry about cancer? Thats some shit to worry about.  Swine flu is a made up thing to make people forget $$ probs	flu
@immuneprotect Afraid of swine flu? 	flu
This is getting absurd. RT @taniaganguli Brandon bass has the flu so #orlando #magic could be down to 0 power forwards tonight	flu
@btfulo wow is swine flu getting much worse in korea SSN?	flu
This year, Chinese calendar year of the pig... Swine flu. Next year is the year of the cock...Anybody else worried? [Scary]	flu
2009 is the year of the pig & we have Swine flu. The matter of worry is 2010 which is the year of the Cock.	flu
@vickytcobra thera flu helping at all girl? Get well soon...everyone is getting sick	flu
"You and your body are getting along better than usual...." -- my horoscope. I do not consider swine flu and kidney stones getting along.	flu
add Flu Bird Horror to the list...	flu
so, I'm kinda nervous that I might have swine flu. my throat feels like it's bruised.	flu
is glad to be home & is thinking about a nap.5 hours at the flu vaccine shot w/ 3 kids was not my ideal way to spen ... 	flu
Don't buy into hysteria created by media about swine flu. Fear of illness and death was promoted by media in 1917-1919 flu pandemic also.	flu
@julianne_hope Urgent Care? Hope everything is ok and you're getting better from that flu.	flu
got that bird flu	flu
I get overly concerned when I see sum wit sum shit covering dey mouth n nose like WTF if u got da swine or flu stay ya ass home	flu
Hmm well I am not feeling well!! Okay no I dont have the Swine Flu I am just feeling anxious for my parents to come back home	flu
Avian Influenza: Korea: Bird Flu outbreak worrying 11 Nov 2009: WorldPoultry.net - A low pathog.. 	flu
I'm at Walgreens getting the flu shot!  I will not got sick this 	flu
Thinking we are lucky to live in a country where the biggest public health crisis is what amounts to a mild flu for most people.	flu
hahaha RT @eniac: Swine flu concern - I’m not really concerned about swine flu.. Here’s my concern. 3 years ago, 	flu
My wife is getting a drive through flu shot. No joke.  	flu
@b_twice interesting (but still not getting flu shot) ---&gt; RT @nytimes NYT NEWS ALERT: Obama Declares H1N1 Flu a National Emergency	flu
CBS Reveals that Swine Flu Cases Seriously Overestimated: Dr. Mercola &#124; The CDC continues to use fear to m.. 	flu
Is there some kind of flu going around? It's like everyone's getting sick all of a sudden. Weird.	flu
Missing my NLO, feel like shit today hope its not pig bird monkey flu	flu
Thinking about bailing out of work early and get some much needed down time not feeling good though,better not be no stinking swine flu	flu
Everyone is getting sick. *puts on dr. mask* I got my flu shot but I dont have much confidence in it.	flu
Off to get my flu shot at our other office which means getting my favorite lunch on the way back, turkey tips from Floramo's!	flu
@MarnieMacLean ah the joys of getting old. At least we know when the weather is changing...oh, wait, are you cause of the flu?	flu
Crap, I think I'm getting sick. Stupid flu season.	flu
Darlington battling the flu this week, but s'western playing tough after getting drilled by mineral pointast week.	flu
I think I have the west Nile SARS H1N1 avion bird flu. Or maybe I'm fine.	flu
Swine flu fears getting out of hand. [pic]  	flu
What do you think about the safety of the swine flu vaccine? Media hype or reson to worry? 	flu
Scared To Death About This Swine Flu!? - 	flu
RT  2006 yr of the cow-Mad Cow disease 2007 yr of the bird-Avian flu 2009-yr of the pig-Swine flu 2010 yr of the cock Anybody else worried?	flu
Better now. Nebulized before it got too awful. My poor little guy. Still getting over flu. Tx for kind words!	flu
@CandaceCalvert THAT'S perrrfect! Of course u'd give the cruise-ship nurse a signed copy of CRITICAL CARE:)  pshhh I was worried u had flu!?	flu
@syancyfox5  No Flu shot for me - Not worth the lines, and your story on Dystonia scared the Beejezus out of me.	flu
getting my flu shots on this a.m.	flu
Got swine flu. Just getting over it. It just the flu with a little stronger affects. This is a money maker for the pharmacy (cont…	flu
thinking about this flu shot I'm about to get.	flu
Rhiza FluTracker: Re: Woman Dies Of Swine Flu AFTER Getting Vaccine: OzarkTom - Read the artic.. 	flu
I am doing good just getting over swine flu	flu
Can I please stop getting the flu??  Rachael Cantu BORDELLO show CANCELED TONIGHT due to the flu.  Please go see Via Tania, she is great! RT	flu
Lebak, Banten ::: Bird flu outbreak in several villages. Bird flu infected chickens disposed to irrigation cana.. 	flu
Pret-tay sure I'm getting sick. Sore throat, stuffy nose. Headache. Just hope it's not Le Flu De Le Swine. #fb	flu
@stellar7 Glad to hear you are getting your strength back. Little guy had the piggy flu, all that remains is an occasional cough.	flu
I'm getting better.....Swine 'flu will NOT be the end of me.....MWAHAHAHAHAHAHAHAHAHAHA!! XP	flu
Is getting his seasonal flu shot.	flu
Might be getting the flu... Hope to god not. I have things to do. Film and work can't take a break.	flu
i have 4% chance of getting swine flu looooool	flu
i'm back! brown bottle flu had me down and out all day saturday. i'm getting old.	flu
just getting home. had a good day except for the fact that my throats still killing me. wants this flu to fly somewhere! =(	flu
Kids are getting their swine flu vaccines tom. Was such a tough decision but with over 100 kids in the next school dist. W/ flu too risky!	flu
is getting through the flu!!	flu
Hey everyone Please cross your fingers I dont get the flu after getting coughed many a times in the face by a little boy who probably has it	flu
@sugarplum7295 thanx....i got the flu and its the worst. yaye your getting to be young after all lol.......	flu
@theodric FLu season is starting. Good lcuk with NOT getting sick!!!	flu
Hope everyone is getting well! School closed for flu for Thursday/ Friday.	flu
Incase any one was thinking of getting the flu or could dont it sucks.. I soo hate being sick	flu
Swine flu in my kids elementary school. Considering keeping them home I am worried	flu
Revenge of animals (: RT@ProminencePR  first we had mad cow disease, then we had bird flu, now we have swine flu, O.M.F.G it's FARMAGGEDON	flu
Flu shot 2morrow. Better be better. Being sick & getting a shot to keep you from getting sick makes you more sick.	flu
i feel like im getting sick!=[ UGH piggy flu stay away!	flu
Worried about swine flu this fall?  Tell us at http://www.momsoutloud.com on our poll, then watch for tips this week! #moms #parents	flu
It just keeps getting better & better. Baby girl sick again-had a runny nose, now nasty sounding cough, temp 99.6. Flu for real this time?	flu
Despite my best efforts to avoid getting sick, I have failed miserably. Ugh! Stupid flu.	flu
@JulieBanderas We're going to have the H1N1 flu shots available at the hospital I work at for staff.  I'm considering getting it.	flu
10 natural ways to avoid getting Swine Flu that don't include getting the untested vaccine! 	flu
I'm awake, fearing the possibility of getting Swine Flu from down in Mexico. Everyone is to now wear a mask while reading my tweets. =\	flu
Getting a flu shot. This spanish influenza is killing me	flu
UGHHH. I think I'm getting the flu that's going around. shit! 8(	flu
a woman just told me she'd shake my hand but is afraid I have the swine flu.	flu
ahh my throat is itchy and nose is kinda running i hope i dont have the swine flu.... or bird flu...	flu
Fear is stupid, and more detrimental to your health than any strain of flu, or any vaccine to prevent you from... 	flu
When Jonghyun got the swine flu I was thinking 'what if another SHINee member will get it too??' and now Onew's got it &gt;_&lt;	flu
Just when I thought I was getting better, my flu decides to rev the engine up again..... *sniffle*sniffle* off to get a lemsip	flu
Getting a lot of work done tired trying to catch up with everything that needs to be done around here me and boys got the flu shot & h1n1	flu
If I'm getting the flu again then one of them 	flu
RT @momlogic:As if worrying about getting swine flu wasn't enough, now you can worry about getting scammed too 	flu
sitting at home  eating subway in my undies watching spongebob lol!!!!  wish I cld go out but just getting over the flu! plus Vegas in 6days	flu
change, as well as fall is in the air, but too bvusy with the flu to worry or care right now.	flu
i am getting a really bad caugh, if i'm getting that bloody pig flu i will not be impressed!	flu
Last day to have your say: Are your kids getting the H1N1 (Swine Flu) Vaccination? Anonymous Poll 	flu
Crap!  Cats are getting f-ing swine flu now.  Stay the F away from me.	flu
I think im getting swine flu either that or I'm dying	flu
@coltaine808   Cause I'm thinking what I had in Spring 2008 knocked my on my ass for a month-- wasn't just "flu", but never tested	flu
@colettewh If you're around people getting the flu, you should definitely get the vaccination.	flu
RT @trishSWFL: I'm not getting the vax---since I seldom catch even a cold || I don't get regular flu vax. But I'm not risking this strain.	flu
Theraflu don't let me down... We are still shutting it down 2NITE!! Maybe I'll rock the bird flu mask	flu
RT @redsoxgirl46:RT @starrphishe My 3-yo nephew has swine flu & worried that my pregnant sister may get it. Prayers appreciated ♥	flu
Remember, your car is 200 times more likely to kill you than the swine flu.  Calling all people to NOT FEAR SWINE FLU.	flu
Dad: "Don't expose yourself to cold. Do your work and come back home. Buy masks and don't go in crowds. Swine flu is not getting better"	flu
It's weird to get sick and have to worry about gettin crazy, scary sick.  It's like the flu is goin' ol' timey. :O)	flu
feeling sick. dunno if it's just ICP headaches getting worse, or I'm getting flu. don't tell my sisters. any of them. resting now...	flu
Isn't it nice Goldman Sachs is getting its swine flu shot before my 2 year old?	flu
Large NYC employers getting swine flu vaccine 	flu
#swineflu Large NYC employers getting swine flu vaccine - The Associated Press: RTE.ieLarge NYC employ.. 	flu
I am worried I may have caught that darn H1N1 Flu... ugh.. not my year of health.. cant wait till 2009 is over	flu
Can Getting the H1N1 Immunization Affect My Unborn Baby? 	flu
Always getting called in on my days off. What the hell, coworkers! This is no time for the flu!	flu
glad i'm not in NC getting the swine flu	flu
@matildajones so don't worry, I was the exception lol. and hey, still beats having swine flu right ;)	flu
@MissKatiePrice Ahhh just herd about Harvey with suspected swine flu :( Hope he's well soon and thinking of you all xx	flu
so im starting to think ive got swine flu. cant hardly breathe. might have to go to the hospital if it keeps getting expontentially worse	flu
@BenjaminGell does everybody have Hackney swine flu lol? Oh dear! I feel ok just now. Oh and I don't have facebook Ben I'm afraid, sorry :(	flu
My son had a high fever since last weekend. I worried if he took a new flu or not. I brought him to the hospital immediatey.	flu
I'm scared, ppl in MD keep dying from swine flu, if I dnt make it I love guys #moviemomment	flu
im getting a flu :(	flu
@corinnapaola So many of my students are getting the flu this year. Have to try to be careful. Drink plenty of fluids & rest	flu
My mom has called me more times in the last 3 days than the last 3 yrs... The media has scared everyone about havin the flu these days...	flu
DRs just found first case of swine flu in a cat in Iowa. Great. Now I have to worry about coughing on the cats.	flu
LOL!!  RT @MrsButterworths Don't worry my dears! You can't get swine flu from having bacon with your pancakes!	flu
@CupcakeCornerUK How are you feeling Charlotte?  Youngest now looks like she's getting the flu - she ASKED to go to bed @4:30!!!	flu
Not feeling up to snuff this week. If I'm even getting swine flu (over the cuckoos nest)... #fb	flu
looking up swine flu just makes me more terrified of influenza. this hypochondriac calls shenanigans on H1N1!	flu
been ill with flu, now maybe sinus infection for 13 days. this is getting OLD - and expensive(self employed=no "sick days") Dr appt today	flu
Successfully fighting off something. I swear by getting seasonal flu shot, more rest, and Wellness Herbal Resistance Liquid (at Whole Foods)	flu
getting over stomach flu. enough catharsis.	flu
finally getting over the flu ... wow this one was wild!  I am counting on a sick free remainder of the year!	flu
.@genderbitch Obama declares flu emergency. Right-wing in favor of flu. Gun owners fear emergency. 	flu
thinking about getting the H1N1 flu shot.has anybody here got the shot yet?	flu
Being surrounded with peeps that have the swine flu sucks cause every little sneeze and cough makes me nervous that I'm getting it..	flu
the Thought of the morning sunshine and Your sparkling face made me realize that this flu is just a flu..... and I am getting better now....	flu
Hand sanitizer does help prevent the flu from getting in your body, but hand-washing is far more effective.	flu
being sad lost my sister to the swine flu and mow our bird died to	flu
Just met with the trainer and we will be missing 6 players with the flu for this mornings practice. Getting the bug-hope it stops soon.	flu
tired. sore. getting sick......swine flu or too many sit ups.....	flu
@JDTheEngineEar oh yea, we be there Dec 13... in full effect... Giving yall the "bird-flu" again!	flu
This really cant be happening.. I have a toothache & I think im getting a cold.. I was just sick last week..  & No I dont have swine flu	flu
@Valerie4012 Yep, but Savannah hasn't had any yet. Getting her immune system through flu season first.	flu
A high school friend passes away from the flu and a few of my friends won't attend the funeral because they fear catching it. Argh. :(	flu
@AMAZINGBOSSUP bird flu goin around on twitter	flu
@ddubswifey69 got home early today. feels like i am getting the flu	flu
Concerned about swine flu, Wolfson Children's Hospital in Jacksonville bans visitors under 18 	flu
seems like these bird profile pics are spreadin like swine flu. hope i dont get infected next :(	flu
East Valley high school teacher dies after getting Swine Flu 	flu
getting flu	flu
ok, ok...i'm breaking down and getting a flu shot this year. ouch!	flu
@ShutterBugGeek Morning Robin! Getting over flu so was sort of blah. Doing better now though. How about you? Enjoy Halloween?	flu
@Marsmellowgurl I have a good immune system. Got AIDS, the bird flu, a broken leg and 3rd degree burns at the same time. Healed 1 day later.	flu
I think im getting sick and 4 ppl frm c0stc0 and 3 frm school already g0t the swine flu. plz dnt let it be!	flu
I *was* getting over my cold. Then I relapsed. Then Spyder came down 	flu
@RowanLarke Oh no, not flu. Thinking healthy thoughts for you!	flu
Good one.RT @washingtonpost A Q&A on how to prevent getting swine flu and what to do if you have it 	flu
I think I feel much better today. I fought off whatever cold or flu I had without getting too sick.	flu
Now they are all getting swine flu #mosthauntedlive	flu
Having the worst Halloween weekend! :( stuck at home with the flu!! :( boo...missing fear valley and hallelujah night!	flu
Thinking about folks I know in Seattle with swine flu. Only a matter of time I guess.	flu
@Ravish30 no flu thankfully, he's had a bad cold since tuesday. worried that going out would just make it worse again	flu
Isle of Wight Swine Flu update 8.05 Monday morning on Topping in the morning - let us know your questions are you worried? #fb	flu
Getting H1N1 shot today! I like to say swine flu instead! They are pigs!! Your not gonna hurt there feelings! http://www.LanceMartin.net #fb	flu
Are you getting the swine flu shot? 	flu
IMHO- compare the risks of Swine Flu and Side Effects of vaccines, examine news reports carefully, make choices based on facts not fear.	flu
Sick at home thinking i have the flu once again :(	flu
I'm now a swine flu H1N1 survivor. At least I don't have to worry about getting the vaccine.	flu
What! Are you OK i'm so worried about you! @markonyou Sweet I have swine flu and I'm in quarantine...	flu
@TempestJumpr i would assume that in somalia they have more to worry about than the flu haha. like AIDS. not somalian AIDS. just AIDS :)	flu
here is the video of the cheerleader who can only walk backwards after getting flu shot - 	flu
@AlbertinaPdC Flu, I fear. I'm actually on leave, was meant to be walking the Northumbria Coast Path today!	flu
Pcp's office won't have H1n1vacc 4 wks - a bad mind game! Flu makes me (& most autoimmune)very sick.Noticing the worry- will walk it off :)	flu
Swine flu fear sidelines Roberts: Jason Roberts has become the latest Blackburn Rovers player to come down with.. 	flu
County running low on seasonal flu vaccine: “We&#39;re afraid we&#39;ll run out.” This year, the county has not.. 	flu
FUCK! Now I KNOW I'm going anywhere! [Wyandotte County man dies after getting Swine Flu!] 	flu
Some idiot passerby asked someone, "do you have avian bird flu?". Sadness...	flu
Is Scared Of Getting Swine Flu !	flu
[PIC] Swine Flu paranoia getting out of hand!! 	flu
is scared and worried about have swine flu	flu
Glad to be well from the flu, finaly getting back to my regular routine:)	flu
thinking of getting a flu shot? watch this & think again. 	flu
Scared of the swines that have the flu.	flu
RT @k4dasoul22: @Twitchnmild its getting cold here.. flu season dnt come ova here lol&lt;---Lmao	flu
@jeffmenig home with swine flu right now! sorry for not getting at you yesterday, slept all day. the swine is serious business.	flu
RT : @garretmaine Ohh shit I'm getting sick :/ fuck you flu shot you didn't do a thing for me (I'm getting sick. shit)	flu
I fear my house is no longer the [swine] flu free zone I hoped it would be. Both brother and I are feeling miserable this evening. Not good!	flu
Son and daughter have h1n1 bihind them. Going to school tomorrow. I'm getting a fever and hoping I have swine flu lite.	flu
Is at the hospital thinking of how much money I could have saved, just for a fancy way of telling me I have the flu	flu
I wasnt worried about the flu, but if thats why brock cant train it must be bad	flu
Brayden has the swine flu! :( Worried, worried, worried	flu
Swine Flu has arrived at my daughter's kindergarten. 2 cases. & I think I'm getting her eye infection. Next few weeks will be fun. =(	flu
Listening to a Dr. talk about H1N1 at the chamber of commerce. I'm terrified right now...get your flu shot!  :-((	flu
Oh dear I fear man flu is on it's way.	flu
getting the swine flu vaccine in about 2 hours and a half and i convinced my parents to let me get an official sony headset for the ps3	flu
My flu is NOT going away!!!!! Its NOT even getting any better!!! I feel awful :(	flu
RT @theoaklandpost: Worried about swine flu? There's free vaccinations being given at Fireside Lounge today.	flu
RT @vboykis The office is scared of swine flu. I've been in Russian public bathroom. Nothing scares me anymore. [Me:Thailand public loo!]	flu
@stephenfry Hope all went well last night and Mark recovers from Swine flu, dont worry it only lasts a weeeeeeeeek (piggy squeal)x	flu
I'm worried my kids won't get the H1N1 vaccine in time. Manufacturers need to step it up, step on it. This flu is spreading like wildfire.	flu
RT@Cliffdoggydog Getting the flu shot?...Read this nice little review of the H1N1 vaccine first: 	flu
I either ate some bad pork or I am getting the flu. Tummy Not feeling good.	flu
Getting over the worse part of a flu virus, going to bed.  Not sure if I'll be going to school tomorrow or not.	flu
@dominionpundit Good read - Fear the quacks, not the flu shot 	flu
the flu sucks...i recommend not getting it.	flu
@TweetDiane im worried like you too...because its so new. my dr pretty much makes me get the regular flu shot each year	flu
i thought i was getting over this flu crap but i guess i was wrong now i feel worser than yesterday.....oh and i have to go to work this day	flu
@miraclelaurie Lucky on the clothing, I don't believe it's so lucky on the lunch. More Bird Flu-y.	flu
is going to take a nap before resuming UDS. Does anyone have any tips for getting over the flu? I already have lots of dayquil in me.	flu
everyone in theatre is getting swine flu :/ doctor's for my smart pills soon	flu
Investors.com - The Administration's Flu Fear-Mongering: 	flu
@wondrous_as_u I have a middle schooler too & they seem to be getting normal flu symptoms with the H1N1, but lots are getting it,	flu
Three weeks, still coughing but getting better. Nasty flu coupled with Bronchitis.	flu
@BellevueHealth ya that flu shot video was yucky!! I'm not getting a flu shot, I've never had one - they seem good to avoid. Good video	flu
Slowly getting the vocals back in shape after being sick from a bad cold (might have been a mild case of swine flu).	flu
@meluhhneecando lol its da bird flu thanks twitter thanx :P *T3AM INFAMOU$*	flu
Tessa has the swine flu. Luckily not much worse than a cough and 	flu
@chriss_yst I've been so worried about her. Don't think Holly should get Tamiflu as she's been so ill in past.Think I probably had Swine flu	flu
feels like i'm getting the flu.	flu
@norwegianne No, I'm afraid not. I'm too tired, still coping with the last bits of a flu... I'll be around tomorrow, though.	flu
AMEN RT @fredshadian: 7 Darn Good Reasons You Need Not Fear the Swine Flu: 	flu
I think I'm getting sick ;s I have a headache, I'm a bit flu-ish and my nose is umhh... "closed"	flu
RT @PriceDoc Heart patients who catch the flu have more to worry about s 	flu
ugh why dont this flu just go away? I started getting better now its coming back..	flu
@PattiC14 have you heard anything about her husband Ray? He also had swine flu before she caught it. I'm worried :(	flu
am I the only one not worried about swine flu?	flu
getting a pig flu shot soon!	flu
@Jeremiah_kk yo man, hope you ok. theres flu pandemic here man, people are getting sick like crazy..	flu
Spent half the day getting flu shots here in NYC (where they're scarce). Got lucky, but now have sore arms from double-duty innoculations.	flu
flu, flu, flu how do you do? Is it swine or is it bird and my dear head why do you hurt? Sage tea overdose. Cheerio	flu
@abigailrieley Hope your flu jab getting better too, sounds as bad as flu!	flu
Morning - afternoon lol just tricked woodys mum into thinking that brucie has died of flu lol	flu
My colds and flu are getting worst.. going to seek medical attention right now.	flu
@pinkladyuk they sacked him... Oh no that's just wishful thinking. He's got a touch of flu and doc says no work. Talk about a brucie bonus!	flu
Swinefluhqs What should the dentist be concerned about in the in the scenario of emerging swine flu 	flu
Dear everyone: please cease and desist with the flu business and any other health problems you may think of getting then spreading, kthxbye.	flu
swine flu getting closer everyday..kids got regular flu shot no swine shot here yet..mom and dad have neither yet	flu
@tweetpea looks wacky for me too. Hopefully it's not a bird flu! lol	flu
@hannahhrawrr actually, I have Bird Flu ;)	flu
Some radio moron claimed 37,000 deaths a year are attributed to the flu. That is a completely made up statistic.It is all fear mongering.	flu
@Jason_Manford - and yet they make the bloody news when they get 'Bird Flu' - it's sexual equality gone mad	flu
@AnnaSCWishes I think I have an ear infection too...but haven't been to the doctor b/c I'm afraid of getting swine flu in the waiting room!!	flu
Waiting in the 1st Covenant Church parking lot for mumma. She's getting her flu shot inside to protect baby.	flu
@jaimeelee17 Yep! Now back at the hotel resting because i'm still getting over my flu from earlier in the week.	flu
#swineflu Schools open amid swine flu concern - Arab News: Schools open amid swine flu concernArab New.. 	flu
I wonder how scared people would be if they broadcasted on CNN everytime someone dies from regular flu... We wouldn't go outside!!	flu
@hollywoodrose 4000 deaths where? 250,000 die every year from seasonal flu, I'm not worried about H1N1 yet. lol	flu
i feel lyk i'm getting the flu=(	flu
Getting ready to go home after a week of dogding swin flu and meating people and a some job inteviews.	flu
Oh I really hope I'm not getting ANY kind of flu right now...	flu
#travel Swine Flu Airlines Flights (source: About): A big concern for many passengers when speaking of i.. 	flu
@cpark Don't worry,  nothing short of swine flu will keep me in his weekend.	flu
Kids got exposed to swine flu Sunday. Now Emily is coughing and a 101.5 fever. Nothing to worry about. Right?	flu
Back in ny...sorry to jet blue for being a bitch. It was the flu and fear of flying combo. We 'hugged' in the end:)	flu
getting ready to leave for work.  I am praying that I don't catch the stmoach flu from my grandmother	flu
@callapidder I've got a kiddo home with the flu.  None of us had a flu shot, so I'm concerned that we all may end up with it.  Ick!	flu
You know when you are getting old when---? I will go first....You know when it takes you 2 weeks instead of 2 days to get over the flu.	flu
@_michii lol. I'm faaaaarrr from lazy. Lol. I'm on my way to work. I feel like shit. I think I may be getting the flu.	flu
112 kids at the public school in my town are out sick. My brother goes there. Guess who's probably getting the flu again? FML.	flu
Getting a flu shot at the Walgreens in E. Boston. I think it's ironic I'm getting the shot at a place where I'm most likely 2 catch the flu.	flu
Just found out /Scared for my family /Swine Flu - I Got a call just a short time ago that my daughter is at the beg... 	flu
getting my flu shot. eeeekkk!	flu
Whose getting the H1N1 Vaccine?! --- RT @Briancbc: H1N1 flu vaccine clinics will open in HRM on Monday Nov. 2nd	flu
I'm getting flu, ugh i hate flu.. It changes my voice and sometimes i can't smell anything.. Annoying	flu
had 2 buy Thera Flu for my mom. shes getting sick	flu
@froggent I was worried I'd be home with a flu kid for a week!	flu
WIfe is out ot town, I have the flu, kids are driving me crazy, and I'm thinking about buying a used Fender Deluxe Reverb.	flu
@UMHealthSystem Teens are getting sicker w/ H1N1 than seasonal flu. But it's younger kids w/ highest hosp rates #H1N1swinefluchat	flu
@jessicaENGSON I hate needles, but yeah its like any other needle. The H1N1 and the flu shot both hurt equally. Are you getting yours too?	flu
@funsized_boss lol ok! but dont get to friendly with those girls...lol that bird flu is contagious ;)	flu
clogged nose, sore throat, very slightly watery eyes. omg! am i getting the swine flu?? or maybe because i played in the rain??	flu
i think im getting the flu! ohh noooooooo ... 	flu
"Why do they have a shot that gives you the flu?" "It doesn't give it to you, it helps prevent you from getting... 	flu
@KristaChelle yeah. i hadn't felt bad at allll. but the past two days i have. i hope i'm not getting flu! ):	flu
is amused that my teacher doesn't want me going in, as she's scared i'll infect the whole class lol! swine flu is overrrrr :D	flu
Jeffrey Wisor talked me into getting a flu shot at the multipurpose center. Geez.	flu
haha swine flu is a trending topic? im pure scared case i get itttttt |:	flu
Getting ready 4 big #pbhhealthfair today... Bring it on. Angry ppl who can't get a flu shot ... I will kill u w kindness (and police backup)	flu
@elpedro444 seriously its absolutey bollocking cold outside - no cloud cover. Maybe I'm just getting swine flu?	flu
So i&#39;m thinking that it not the flu, just the same stomache issues I have been dealing with for like a week now... Can I have one day wh	flu
Is at home sick with the flu today but don't worry it's just the normal one not the H1N1 :(	flu
RT CNN 5000 swine flu vaccinations trasnferred to #Gaza tdy by #Israel . Heres our story this week on H1N1 fear.. 	flu
Here's what's a drag: know not supposed to touch face, to avoid getting flu germs on, but allergies mean always wanting to rub itchy eyes.	flu
Tweeps 2 follow: Americans are supposed to be scared of HIM, not the dumb flu! Let's get some perspective! @Real_Bin_Laden #followfriday	flu
Worried that you might have the H1N1 Swine flu? Visit the H1N1 Response Center and take the online assessment 	flu
So miserable today. Hope I'm not getting the flu-I just got over an effing sinus infection! I hatehatehate this constantly changing weather!	flu
@dizzeerascal me and Nina from Dollie Mix are just getting over Swine Flu	flu
Half of my class is out from the flu or apparently scared to come to class with everything happening. Campus is crazy anymore.	flu
RT @jaset: 1 third dont trust swine flu vax 	flu
Dinner= tv dinner half frozen, nutrigrain bar and rice crispy treat. I'm getting my body ready to fight swine flu. Antibodies unite!	flu
Thought the flu shot was supposed to PREVENT the flu. I was feeling fine b4 getting the shot this week. Now, not so much.	flu
am i wrong- i thought swine flu was different than h1n1- h1n1 has the swine flu, but also has bird and human flu strains right?	flu
is @ work til 7...my lil man is getting his swine flu shot today : ( and his teacher informed us today that he needs speech therapy	flu
@Twitter_Tips go tweet go!! Safety first, think smart..them bird flu are relentless meanies!! 	flu
I think I 'm getting a cold or swine flu. Noses hurt...... auuuuuu.	flu
is it just me that's more scared of just plain ol' FLU than H1N1? compare the annual death toll of both, people.	flu
#moronail [ People worried about swine flu. ] 	flu
So tired of all these hypochondriacs freaking out about the swine flu. I mean, seriously...I work at a germ factory...still not worried.	flu
Swine Flu - How worried are you? - Take our poll now and check out how others feel! 	flu
I hadn't seriously worried about swine flu before now, but I'm at my doctor's office surrounded by people in masks. Feeling antsy.	flu
RT @daveshackleford: Wow. For those of you SCARED about #H1N1: Get a life. It's the damn FLU. Why are we so wor.. 	flu
RT @GovSteveBeshear 	flu
RT @PharmacyGuru: » Public school kids are getting swine flu vaccines without ... 	flu
I had flu jab today and I'm eligible for swine flu jab. The doctors are getting the vaccine from next week onwards.	flu
Sitting at my desk thinking that going camping for halloween is a receipe for getting the flu	flu
thinking wh did i finally get the swine flu	flu
Maybe it's because of fear of swine flu that no trick or treaters came. Main thing is.... chocolate. #goodhalloweeninmybook	flu
@kerrycounsell Could be a weird new kind of bird flu - ouch! Which Indian restaurant do you recommend?	flu
Well my boyfriend has the flu, maybe swine...so I guess this means I'll be getting it soon.	flu
Okay I'm getting mad at the news now, some much hype about the swine flu I had a dream I woke up with H1N1?? How stupid is that?? lol	flu
is getting over an aggressive, NASTY flu bug... doubt it's H1N1, but if it is, I'm winning... ugh, painfully.	flu
H1N1 aka Swine Flu aka The Swizzles.....god I don't want to even get a common cold this year. I might start thinking I got SWIZZLES!! Ewwww!	flu
@tlockemy I'm good. Just getting over the swine flu. Not so fun. As for my job, I love it. I work with some wonderful people. It's great.	flu
Me and my family are all getting over the flu.	flu
Day three of health drive I am feeling unwell. Hope it is not swine flu - how can getting healthy make you feel ill??	flu
@puffandruffle I currently hate my female organs right now too :p plus I'm just getting over a nasty flu, not sure if it was h1n1 or not.	flu
i really hope i'm not getting sick now. i havent felt well the last couple of days. i swear if this is swine flu i'm killing @SCC_Skwerl	flu
Crap.  I might be getting sick again.  SWINE FLU!	flu
What is the status of swine flu? Is getting more wide spread? Where the most sever cases? Is it adapting to treatments? Questions, Answers?	flu
Amid all the other things Afghanistan needs to worry about, the country is today reporting its first swine flu human death. #H1N1	flu
Swine flu fear is now a full blown pandemic in T.O. Go media go!	flu
I think Im getting flu soon.	flu
OmniFootball » Ancelotti – Worried about Swine Flu? Drink red wine ...: Read &#39;Ancelotti – Worried about Swi.. 	flu
ive been banished to my room...ooh flu, your really getting on my nerves...thanks, west penn hospital !	flu
Ok fever!!! Worried!! Might be in quick care tomorrow making sure no flu!!! Right before a trip GREAT!	flu
not feeling well...  I hope I am not getting the flu.  Went home early, and not allowed back for the rest of the week.  work from home then.	flu
Word from Chas Dorman is Lucic is headed south on a plane after getting over the flu (reason he was held back). 	flu
Got Swine Flu! Feel dreadful. Getting prepared to get back into writing my books, and starting a new ruplican petition. I want a democracy!	flu
everyone has been getting sick. were all getting the swine flu :D haha	flu
I'm worried Mom may have the flu... Please keep her in your positive thoughts and prayers!	flu
Mom had the Swine Flu recently. She's getting over that, but her COPD is giving her a rough time. Hopefully she can be able to walk & breath	flu
@Ann_run Hi Ann - thanks for asking! yep, stomach flu, getting a bit better today though. Commuting has been a pain in the *** this week:)	flu
Why do I keep on getting sick. Well I'm fighting it right now, but I just got over the flu. WTF! Hmmm some tea sounds nice right now.	flu
@jakehurwitz Get well soon! Don't worry, lots of people here are having flu-like symptoms too, even me	flu
Are you worried about this Novel H1N1 Swine Flu? Take the poll and see what others say. #Swineflu #h1n1 	flu
At the dentist's office and concerned that I'll contract swine flu if I touch one of the obligatory waiting room magazines.	flu
@kamichat WOW. Guess I oughta reconsider getting those flu shots....	flu
[News] Swine flu fear keeps teen hospital volunteers home: Swine flu has emptied classrooms and filled va.. 	flu
Swine Flu Is Coming I Am Scared Need The Shot..	flu
@thePropertyDiva I'm not getting near any swine flu victims. I'm easily infected. You wouldn't believe the things I've picked up in Asia.	flu
Getting hit by a Mack truck is a lot more painfull then a flu shot Getting killed by either one unlikely for most Flu shot 1 second pain?	flu
Morning, y'all!! I scared the crap outta myself by watching a swine flu report & the chimp attacked woman. We don't NEED to see everything!	flu
Fuck Swine Flu or H1N1 Virus omfg.. ppl need lives instead of thinking up a gay name like H1N1 for the Swine Flu..	flu
I dont feel well. think I have bird flu. I'm retro like that.	flu
With flu season setting in, we stay healthy by avoiding processed foods, staying active and getting 7-8 hours of sleep. How do you?	flu
RT @toddstarnes If you see Army tanks parked outside your local barbecue joint -- worry. Day One of the National Swine Flu Emergency.	flu
sitting in the doctors office with kids getting their flu shots	flu
I think I am getting sick now. Thank you to all who have shared the flu with me.	flu
You know the swine flu fever is getting too bad when my 5 years old tells me she's scared of the dirt on her hands bc she might get it. Grr.	flu
@mandalot That's true - I never get flu just colds! I was just thinking if I'm gonna do IVF in Jan I might need it! I'll av a chat with GP	flu
Still dont know if Im getting a flu shot. And if so which one??? Both... more than likely neither	flu
its getting COLD in faner!!!!!!!! great....i just got over the flu	flu
@kaylaiscool16 Wow welcome back, last time you were on you were sick, I was thinking you got the swine flu.	flu
@christianhughes not bad thanks, just getting over flu. was HORRID! onwards & upwards though eh? :_	flu
Getting a flu shot is simply trading the possibility of a big flu for the certainty of a small one. I speak from experience today	flu
pray for my daughter Lacey - diagnosed w/ swine flu up at school - very ill. Worried parents :(	flu
With all the flu and viruses going around, I'm thinking of having myself laminated...	flu
lol rt @Daggetdbeaver RT @dancourtois: Bird flu questions? 	flu
Getting over the flu... Gotta start studying for this economic statistics test monday... sigh :-(	flu
I'm shivering now...something tells me I'm getting a flu ç_ç	flu
feels icky. I think I'm getting the flu...not necessarily THE flu, but a flu. 	flu
@nickcognito Cats getting swine flu?! Oh no! Maybe this way I can at least convince the bf to get the H1N1 vaccine.	flu
taking Aaliah to school, then picking her up early/ whole family going nd getting flu shots =(. shopping and might go sign up 4 school 2day.	flu
@crystalchappell   would ike to know if Cathie is getting better though..really concemed.flu or swine flu is bad news.	flu
I'm actually excited to work tomorrow. It'll be the first time getting out of the house since Sunday. Damn Flu	flu
My family is getting smaller. André gave up, Ritinha and Fernando went to another city, PM has the flu, Leo and J.P. gave up too...	flu
got a flu shot today and momma got a cat scan because sum1 last friday rear-ended her car, and the lady, who was at fault, is getting nasty.	flu
@blounderground i am jealous. And so not getting swine flu btw	flu
We have a nice sunny day here btw.  My son is getting over the flu. Have kept him at home today	flu
At the health dep. Getting h1n1 flu shots for my girls. Too bad I am in a red state, adult males don't get vaccinated.	flu
@Rubyletters think am getting flu or something .. sore throat, cough, etc ...	flu
is hoping that it's not swine flu I'm getting!	flu
Okay so question? I am really scared about that H1N1 bc all these confusing stories. you would be really sick right. kinda like the flu	flu
@WorTony got the flu on the way home, so was wasted for a week, followed by 8 devs getting sacked @ work :-( #spc09	flu
getting some work done tonight, flu not going to stop me!!!	flu
RT @2Serenity: REBUKE THE FLU! RT @worldprayrGetting hit by the flu, hopefully it's not the swine. Plse pray! #worldprayer	flu
Dr. thinks my son has H1N1, since he got a regular flu shot 3 wks. ago & is very sick now.  I'm concerned - he's sleep-deprived & run down.	flu
For Bird Flu you take a TWEETMENT; for Swine Flu you take an OINKMENT!	flu
Michael has caught the flu. maybe mexican! We're afraid tommorow's gig has to be cancelled... Next gig is 4 december @ Victorie, Alkmaar	flu
@carareed He's getting like 3 shots. no flu till nov though	flu
RT @greenlinebus: @drewmaniac I see the illness has not affected your tweeting. Guess we can rule out bird flu as well.	flu
is down with a cold. To be clear, I was already feeling sick before getting the H1N1 and seasonal flu shots.	flu
@kellidunlap we've never gotten the flu after getting the shot...and we got it over a month ago, so I doubt it was direct cause.	flu
in bed bad flu.. my insane schedule has finally caught up with me. getting tons of website/ computer work done	flu
Many Americans Undecided About Getting Flu Vaccine 	flu
Why shld employers B forced 2 pay 4 sick leave(if not offered already) 4 pple who get swine flu?? Again, getting $$$ 4 doing nothing! #tcot	flu
Getting over the flu again & lost more weight. So here's the plan, get the flu 2 more times & I'll be back to my ideal weight ☺	flu
Swine Flu Fear Syndrome: This post is more or less in direct opposition to Bakhrom&#8217;s post on Swine Flu.  .. 	flu
@imjust_sayin sympthoms of the flu!!! this shyt is for the birds *cues bird call*	flu
I'm concerned for my mother.. She jus went to tha ER wit flu-like symptoms.. On top of tht she's 8 mths pregnant.. Pray 4 her..	flu
Swine flu is so much fun. No better way 2 spend a Saturday than at the hospital worried sick about ur kid. Ugh.	flu
And I'm so wet because of the rain! And my flu is getting worse! Huaaa 	flu
RT @husani93: RT @photo_b: 	flu
im thinking you better not have swine flu or im fucked.. ... 	flu
@DVC_Owners I can't shut the blowers (AC) off in our room. We all came down here about 80-90% from getting over flu. Not much here at night	flu
Phew! Good to hear! RT @prairiepaperie: Official wrd FLU. She gets 2 tough it out lk the rest of us. Lungs arnt bad enough 2 B too concerned	flu
CNN Opinion:  Eating Animals is Making Us Sick (and causes global warming, swine & bird flu)  	flu
1 day down, 5 to go until my 2 days off. It's gonna be painful (especially as I think I'm getting the flu that's going around)	flu
The company is giving away free flu shots on Wednesday. Guess who's not getting the flu this season!?	flu
Thankfulness in November:  Thankful Jordano hasn't caught the Swine flu yet and that Kelsie is better... and Dave is slowly getting better!	flu
Hit with flu-like symptoms after UKLUG and only just getting back on my feet. Missed Twitter and TweetDeck more than I thought	flu
Gonna be a shifty winter. Fuck it. Getting my flu shot nxt week.	flu
Flu Threat Looms As Mecca Readies For Pilgrims: The H1N1 virus is a major concern for Saudi Arabian authorities, who... 	flu
@KGMB9  I am a cat person...but I would be terrified to find out the vet bills to treat swine flu in my cats. Ugh!	flu
I wonder what the next animal flu is going 2 be. Since we have already had bird & swine I am hoping 4 something marine. How bout "fish flu."	flu
getting ready to go to class. bo's sickness is on day 15. this flu is no joke, well it's bronchitis now.	flu
Worried about the swine flu? Have you received your shot? Tune in to Starstyle-Be the Star You Are! Thursday 3-4pm where we talk H1N1.	flu
#jordanesque Kobe scoring 31 and getting the W in overtime while fighting the flu.	flu
Think I'm getting the flu-no not H1N1, just the run of the mill flu. More likely just a cold.	flu
Crazy line at Cal State everyone Getting the Swine Flu Vaccinations.	flu
One child just got over the flu, now it looks like the other one is getting sick ☹	flu
why is tmds myspace redirecting me to'calcualte your chances of getting swine flu' on fb? :S :'(	flu
I just realized that because of Swine Flu I haven't fixed my hair since Wed - and I didn't try real hard that day because I was getting sick	flu
dude, i am so fricking tired, just getting out o the flu, haven&#39;t talked to anyone so don&#39;t freak out baby....	flu
no. I'm not getting it! RT @AirAmericaMedia Poll: Are you worried about the downside of the new swine flu vacci.. 	flu
My dustin and I are sick .... he is getting treated for the swine flu... I have a bad cough ....:( I hope we r better 4 halloween	flu
Swine flu apps you'll want on your iPhone: If you're worried about the swine flu, keeping up to date on the latest news  	flu
Wow there's a new bird flu strain found up in wales in a hospital and it the tamiflu can't cure it smh	flu
@GwendiBenga Getting my flu jab(s) on Mon. DLA medical this Fri. Have veered from 'panic' to 'can't give a toss'. I am how I am!	flu
RT @ShelahMarie: Did anyone else see that crazy video of that girl who can only walk backwards after getting a flu reservation-reservation??	flu
"...there is no reason to believe that getting a flu shot will cause this,as he hasn’t come across anything to link Dystonia and the shot."	flu
RT @secrettweet: Been sick for a month with flu, now it's in my lungs and I'm scared. Unemployed and no health insurance. 	flu
@MariamMKobras  OH NO OH NO, You're maybe getting hamthrax (swine flu?)	flu
RT @acfryatt: Why is everyone getting Swine Flu? You know the rule: if you get sick, die quickly. #WhatRepublic.. 	flu
I'm getting better! (: I'm gonna kick swine flu in the ass.	flu
RT @SentinelNews: Swine flu case in Longton at Edensor Technology College 	flu
Just getting over the flu:( I DO NOT ever want that again!	flu
90% of the german population has denied the flu shot out of fear of its possible adverse response. http://alivemaxeurope.com	flu
Large NYC employers getting swine flu vaccine: The government-funded vaccine is being distributed to states, wh.. 	flu
Getting over the dreaded Swine Flu - its no joke!!! from a true maple syrup lover you must read this - 	flu
@FreshOutJANINE thanks again for tonight janine, sorry for leaving early- still getting over the flu! Hope the sales a huge success :)	flu
@Devilish_Sunny arugh.. oh hehe 2 kids on my school had the swine flu.. but nothin happen &lt;3&lt;3 dont be scared! &lt;3	flu
Is better from the flu but now im getting a cold and i hate the snow that was on the ground this morning	flu
I'd like to line up for the Pig Flu shot, but I'm afraid of catching Hypochondria.	flu
@stephenfry Are you sure it wasn't bird-flu from Sirocco?! They were getting very close. Will Mark still be at RGS tonight? Hope so-excited.	flu
getting flu with a million uni projects to do = not fun D:	flu
@alterhealth Afraid of the swine flu? 	flu
@BrainsEnough ((I experienced that too getting my flu jab this year. I made the terrible mistake of going to see Paranormal Activity on--	flu
Lol birdass nuca lol #shecutebut she got that permanent bird flu lol	flu
@betsymilf Su Jin's sick too... everyone's getting the swine flu.	flu
Everyone's getting diagnosed with swine flu? Ottawa, can't you take care of your citizens heath a little better?	flu
@GraceTimothy my thinking too, rather risk flu again than defects, could never forgive myself, I'm takeing care of myself&'healthy preg so..	flu
I may have jumped the gun on thinking this flu was gone. Every breath in and out today is painful and shallow.	flu
Scared of catching swine flu? Or, is it just a bunch of hype? 	flu
If U DON'T get H1N1 sho get bacterial pneumonia &seasonal flu shots-won't prevent getting H1N1 will help if U get bact pneumonia&gt;flu killer	flu
Redskins cheerleader disabled after getting flu vaccine - 	flu
I swear I can't stand hearin about dis shit.. Fuckin Swine, Avian (bird) flu, Fuckin SARs.  Every year its something..	flu
@terryrward Maybe the Gitmo detainees should be kept in isolation to prevent them from getting Swine Flu. (#Punday)	flu
This swine flu thing is getting to my nerves.... at school we are preparing Hallowe'en... spooky	flu
i think im getting the dwts flu!! lol	flu
What are everyone's views on the swine flu? Nothing to worry abt if ur healthy or something to hide under covers from?	flu
Afraid my kid may have the flu. Mother-in-law said to encircle his bed in onions. Unsure whether to give that one a "huh?" or to let it go.	flu
RT @JoselinMane: I am at Apple Store on Boylston getting a new iPhone because my current has  swing Flu virus ;-(	flu
